date, author, committer, additions, deletions, total, comments, messageLength
Wed Nov 20 15:34:14 GMT 2019, Mike Bostock, Mike Bostock, 11, 3, 14, 0, 24
Wed Nov 20 15:32:23 GMT 2019, Mike Bostock, Mike Bostock, 1, 1, 2, 0, 6
Wed Nov 20 15:32:18 GMT 2019, Mike Bostock, Mike Bostock, 17, 17, 34, 0, 16
Tue Nov 19 00:28:27 GMT 2019, Mike Bostock, Mike Bostock, 34, 34, 68, 0, 21
Sun Nov 17 22:50:51 GMT 2019, Mike Bostock, Mike Bostock, 1, 1, 2, 0, 6
Sun Nov 17 22:50:47 GMT 2019, Mike Bostock, Mike Bostock, 34, 34, 68, 0, 21
Sun Nov 17 16:16:23 GMT 2019, Mike Bostock, Mike Bostock, 1, 1, 2, 0, 6
Sun Nov 17 16:16:17 GMT 2019, Mike Bostock, Mike Bostock, 182, 181, 363, 0, 20
Sat Nov 16 20:59:39 GMT 2019, Mike Bostock, Mike Bostock, 1, 1, 2, 0, 6
Sat Nov 16 20:59:33 GMT 2019, Mike Bostock, Mike Bostock, 17, 17, 34, 0, 16
Sat Nov 16 19:53:24 GMT 2019, Mike Bostock, Mike Bostock, 1, 1, 2, 0, 6
Sat Nov 16 19:52:39 GMT 2019, Mike Bostock, Mike Bostock, 729, 718, 1447, 0, 20
Wed Sep 25 06:15:09 BST 2019, Mike Bostock, Mike Bostock, 2, 2, 4, 0, 17
Tue Sep 24 23:43:58 BST 2019, Tom MacWright, Mike Bostock, 3, 3, 6, 0, 29
Sat Sep 07 04:55:15 BST 2019, Mike Bostock, Mike Bostock, 1, 1, 2, 0, 6
Sat Sep 07 04:55:08 BST 2019, Mike Bostock, Mike Bostock, 14, 14, 28, 0, 17
Wed Aug 21 07:39:36 BST 2019, Mike Bostock, Mike Bostock, 1, 1, 2, 0, 6
Wed Aug 21 07:39:26 BST 2019, Mike Bostock, Mike Bostock, 80, 78, 158, 0, 26
Wed Aug 21 05:00:59 BST 2019, Mike Bostock, Mike Bostock, 1, 1, 2, 0, 6
Wed Aug 21 05:00:47 BST 2019, Mike Bostock, Mike Bostock, 3, 3, 6, 0, 17
Mon Aug 19 20:22:50 BST 2019, Mike Bostock, Mike Bostock, 1, 1, 2, 0, 11
Mon Aug 19 20:20:52 BST 2019, Mike Bostock, Mike Bostock, 2, 0, 2, 0, 15
Mon Aug 19 20:19:06 BST 2019, Mike Bostock, Mike Bostock, 422, 415, 837, 0, 11
Mon Aug 19 17:47:33 BST 2019, Mike Bostock, Mike Bostock, 1, 1, 2, 0, 6
Mon Aug 19 17:42:48 BST 2019, Mike Bostock, Mike Bostock, 273, 92, 365, 0, 20
Thu Aug 15 14:59:35 BST 2019, Mike Bostock, Mike Bostock, 8, 8, 16, 0, 22
Thu Aug 01 15:58:12 BST 2019, Mike Bostock, GitHub, 4, 4, 8, 0, 24
Thu Aug 01 15:57:55 BST 2019, Mike Bostock, GitHub, 8, 5, 13, 0, 24
Thu Aug 01 15:48:52 BST 2019, Mike Bostock, GitHub, 1, 1, 2, 0, 24
Fri Jun 28 05:35:12 BST 2019, Mike Bostock, Mike Bostock, 1, 1, 2, 0, 5
Fri Jun 28 05:35:12 BST 2019, Mike Bostock, Mike Bostock, 3, 3, 6, 0, 16
Fri Jun 28 03:48:56 BST 2019, Mike Bostock, Mike Bostock, 1, 1, 2, 0, 5
Fri Jun 28 03:48:49 BST 2019, Mike Bostock, Mike Bostock, 3, 3, 6, 0, 16
Thu Jun 27 21:14:33 BST 2019, Mike Bostock, Mike Bostock, 1, 1, 2, 0, 5
Thu Jun 27 21:14:33 BST 2019, Mike Bostock, Mike Bostock, 3, 3, 6, 0, 16
Wed Jun 26 19:19:13 BST 2019, Mike Bostock, Mike Bostock, 1, 1, 2, 0, 5
Wed Jun 26 19:19:13 BST 2019, Mike Bostock, Mike Bostock, 3, 3, 6, 0, 20
Wed Jun 26 19:06:33 BST 2019, Mike Bostock, Mike Bostock, 1, 1, 2, 0, 5
Wed Jun 26 19:06:31 BST 2019, Mike Bostock, Mike Bostock, 10, 6, 16, 0, 20
Thu May 02 15:23:05 BST 2019, Mike Bostock, GitHub, 1118, 1118, 2236, 0, 18
Thu Mar 14 16:13:15 GMT 2019, Mike Bostock, Mike Bostock, 1, 1, 2, 0, 5
Thu Mar 14 16:13:06 GMT 2019, Mike Bostock, Mike Bostock, 71, 74, 145, 0, 16
Sun Feb 10 04:34:31 GMT 2019, Mike Bostock, Mike Bostock, 1, 1, 2, 0, 5
Sun Feb 10 04:34:30 GMT 2019, Mike Bostock, Mike Bostock, 4, 4, 8, 0, 27
Thu Feb 07 20:17:24 GMT 2019, Mike Bostock, Mike Bostock, 1, 1, 2, 0, 5
Thu Feb 07 20:17:20 GMT 2019, Mike Bostock, Mike Bostock, 6, 2, 8, 0, 14
Tue Feb 05 00:07:31 GMT 2019, Mike Bostock, Mike Bostock, 1, 1, 2, 0, 5
Tue Feb 05 00:07:28 GMT 2019, Mike Bostock, Mike Bostock, 2, 2, 4, 0, 15
Mon Feb 04 20:25:22 GMT 2019, Mike Bostock, Mike Bostock, 1, 1, 2, 0, 5
Mon Feb 04 20:25:18 GMT 2019, Mike Bostock, Mike Bostock, 2, 2, 4, 0, 16
Mon Jan 28 17:59:00 GMT 2019, Mike Bostock, Mike Bostock, 1, 1, 2, 0, 5
Mon Jan 28 17:50:36 GMT 2019, Mike Bostock, Mike Bostock, 30, 15, 45, 0, 20
Sun May 13 12:31:34 BST 2018, denisname, Mike Bostock, 11, 8, 19, 0, 145
Wed Aug 29 17:29:06 BST 2018, nikolas, Mike Bostock, 1, 1, 2, 0, 33
Fri Aug 24 22:48:27 BST 2018, Mike Bostock, Mike Bostock, 3, 0, 3, 1, 11
Fri Aug 24 22:43:31 BST 2018, Mike Bostock, Mike Bostock, 1, 1, 2, 0, 5
Fri Aug 24 22:43:24 BST 2018, Mike Bostock, Mike Bostock, 1, 1, 2, 0, 14
Fri Aug 24 22:41:41 BST 2018, Mike Bostock, Mike Bostock, 88, 84, 172, 0, 20
Mon Aug 20 22:06:06 BST 2018, Mike Bostock, Mike Bostock, 1, 1, 2, 0, 5
Mon Aug 20 22:05:57 BST 2018, Mike Bostock, Mike Bostock, 157, 361, 518, 0, 27
Sat Jun 16 19:08:06 BST 2018, Mike Bostock, Mike Bostock, 1, 1, 2, 0, 5
Sat Jun 16 19:07:51 BST 2018, Mike Bostock, Mike Bostock, 30, 33, 63, 0, 16
Fri May 11 20:28:39 BST 2018, Mike Bostock, Mike Bostock, 1, 1, 2, 0, 6
Fri May 11 20:27:54 BST 2018, Mike Bostock, Mike Bostock, 4, 3, 7, 0, 26
Wed May 09 15:40:33 BST 2018, Mike Bostock, Mike Bostock, 1, 1, 2, 0, 6
Wed May 09 15:39:37 BST 2018, Mike Bostock, Mike Bostock, 2, 2, 4, 0, 17
Mon May 07 18:30:39 BST 2018, Mike Bostock, Mike Bostock, 1, 1, 2, 0, 5
Mon May 07 18:27:53 BST 2018, Mike Bostock, Mike Bostock, 6, 4, 10, 0, 32
Thu May 03 09:41:00 BST 2018, denisname, Mike Bostock, 11, 10, 21, 0, 32
Tue Apr 17 21:54:26 BST 2018, Mike Bostock, Mike Bostock, 1, 1, 2, 0, 5
Tue Apr 17 21:54:20 BST 2018, Mike Bostock, Mike Bostock, 9, 7, 16, 0, 16
Tue Apr 17 16:36:00 BST 2018, Mike Bostock, Mike Bostock, 1, 1, 2, 0, 5
Tue Apr 17 16:35:53 BST 2018, Mike Bostock, Mike Bostock, 4, 0, 4, 0, 16
Mon Apr 16 17:23:09 BST 2018, Mike Bostock, Mike Bostock, 1, 1, 2, 0, 5
Mon Apr 16 17:22:56 BST 2018, Mike Bostock, Mike Bostock, 12, 6, 18, 0, 20
Sat Mar 31 01:19:38 BST 2018, Mike Bostock, GitHub, 1, 1, 2, 0, 13
Thu Mar 22 23:25:40 GMT 2018, Mike Bostock, GitHub, 1, 1, 2, 0, 17
Thu Mar 22 23:24:57 GMT 2018, Mike Bostock, GitHub, 1, 1, 2, 0, 17
Thu Mar 22 18:12:10 GMT 2018, Mike Bostock, Mike Bostock, 1, 1, 2, 0, 15
Thu Mar 22 18:10:29 GMT 2018, Mike Bostock, Mike Bostock, 1, 1, 2, 0, 15
Thu Mar 22 18:08:24 GMT 2018, Mike Bostock, Mike Bostock, 4, 0, 4, 0, 15
Thu Mar 22 18:07:21 GMT 2018, Mike Bostock, Mike Bostock, 4, 4, 8, 0, 15
Thu Mar 22 17:56:37 GMT 2018, Mike Bostock, Mike Bostock, 1, 0, 1, 2, 11
Thu Mar 22 17:55:43 GMT 2018, Mike Bostock, Mike Bostock, 36, 0, 36, 1, 15
Thu Mar 22 17:30:10 GMT 2018, Mike Bostock, Mike Bostock, 337, 21, 358, 0, 5
Wed Feb 28 02:15:18 GMT 2018, Mike Bostock, Mike Bostock, 23, 29, 52, 0, 10
Wed Feb 07 18:55:49 GMT 2018, Mike Bostock, Mike Bostock, 0, 1, 1, 0, 16
Wed Feb 07 18:54:52 GMT 2018, Mike Bostock, Mike Bostock, 91, 89, 180, 0, 11
Wed Feb 07 18:52:23 GMT 2018, Mike Bostock, Mike Bostock, 1, 17, 18, 3, 29
Mon Jan 29 15:12:32 GMT 2018, Mike Bostock, Mike Bostock, 67, 67, 134, 0, 31
Mon Jan 29 13:36:22 GMT 2018, Mike Bostock, Mike Bostock, 489, 0, 489, 0, 14
Mon Jan 29 13:27:16 GMT 2018, Mike Bostock, Mike Bostock, 8, 6, 14, 0, 11
Sun Jan 28 19:29:39 GMT 2018, Mike Bostock, Mike Bostock, 4, 1, 5, 0, 26
Sun Jan 28 19:27:25 GMT 2018, Mike Bostock, Mike Bostock, 1, 1, 2, 0, 11
Sun Jan 28 19:25:27 GMT 2018, Mike Bostock, Mike Bostock, 146, 58, 204, 0, 26
Thu Jan 18 19:47:59 GMT 2018, Mike Bostock, Mike Bostock, 1, 1, 2, 0, 14
Thu Jan 18 19:41:55 GMT 2018, zan, GitHub, 1, 1, 2, 0, 521
Tue Dec 26 21:52:07 GMT 2017, Mike Bostock, Mike Bostock, 1, 1, 2, 1, 6
Tue Dec 26 21:52:06 GMT 2017, Mike Bostock, Mike Bostock, 1, 1, 2, 2, 24
Tue Dec 26 19:51:25 GMT 2017, Mike Bostock, Mike Bostock, 1, 1, 2, 0, 6
Tue Dec 26 19:51:13 GMT 2017, Mike Bostock, Mike Bostock, 5, 5, 10, 0, 28
Tue Nov 21 22:03:49 GMT 2017, Mike Bostock, Mike Bostock, 1, 1, 2, 0, 6
Tue Nov 21 22:01:26 GMT 2017, Mike Bostock, Mike Bostock, 15, 11, 26, 0, 20
Tue Oct 03 18:24:17 BST 2017, Mike Bostock, Mike Bostock, 1, 1, 2, 0, 6
Tue Oct 03 18:23:23 BST 2017, Mike Bostock, Mike Bostock, 20, 7, 27, 0, 20
Sat Jul 08 17:07:59 BST 2017, alexmacy, Mike Bostock, 2, 2, 4, 0, 13
Sat Jul 08 04:16:42 BST 2017, alexmacy, Mike Bostock, 1, 1, 2, 0, 14
Fri Jul 07 19:16:53 BST 2017, alexmacy, Mike Bostock, 23, 22, 45, 0, 218
Sun Sep 03 19:25:46 BST 2017, Mike Bostock, Mike Bostock, 1, 1, 2, 0, 6
Sun Sep 03 19:25:39 BST 2017, Mike Bostock, Mike Bostock, 1, 1, 2, 0, 16
Sat Sep 02 23:31:45 BST 2017, Mike Bostock, Mike Bostock, 1, 1, 2, 0, 6
Sat Sep 02 23:28:43 BST 2017, Mike Bostock, Mike Bostock, 16, 12, 28, 0, 169
Sat Sep 02 23:24:38 BST 2017, Mike Bostock, Mike Bostock, 0, 511, 511, 0, 25
Fri Jul 14 22:03:03 BST 2017, Mike Bostock, Mike Bostock, 2, 2, 4, 0, 6
Fri Jul 14 22:02:38 BST 2017, Mike Bostock, Mike Bostock, 530, 13, 543, 0, 20
Tue May 16 15:50:13 BST 2017, Mike Bostock, Mike Bostock, 1, 1, 2, 0, 5
Tue May 16 15:50:09 BST 2017, Mike Bostock, Mike Bostock, 2, 2, 4, 0, 20
Mon May 15 20:20:34 BST 2017, Mike Bostock, Mike Bostock, 1, 1, 2, 0, 5
Mon May 15 20:20:15 BST 2017, Mike Bostock, Mike Bostock, 32, 12, 44, 0, 7
Sat Apr 15 06:35:56 BST 2017, Mike Bostock, Mike Bostock, 1, 1, 2, 0, 5
Sat Apr 15 06:35:50 BST 2017, Mike Bostock, Mike Bostock, 4, 3, 7, 0, 20
Fri Mar 24 16:07:03 GMT 2017, Mike Bostock, Mike Bostock, 1, 1, 2, 0, 5
Fri Mar 24 16:06:47 GMT 2017, Mike Bostock, Mike Bostock, 1, 1, 2, 0, 15
Wed Mar 22 14:54:56 GMT 2017, Curran Kelleher, Mike Bostock, 1, 1, 2, 0, 44
Mon Mar 13 16:10:29 GMT 2017, Mike Bostock, Mike Bostock, 1, 1, 2, 0, 5
Mon Mar 13 16:10:02 GMT 2017, Mike Bostock, Mike Bostock, 1, 1, 2, 0, 14
Fri Mar 10 18:29:59 GMT 2017, Mike Bostock, Mike Bostock, 1, 1, 2, 0, 5
Fri Mar 10 18:29:16 GMT 2017, Mike Bostock, Mike Bostock, 31, 31, 62, 0, 20
Thu Mar 02 20:35:19 GMT 2017, Mike Bostock, Mike Bostock, 1, 1, 2, 0, 5
Thu Mar 02 20:34:48 GMT 2017, Mike Bostock, Mike Bostock, 3, 3, 6, 0, 20
Tue Feb 28 20:22:40 GMT 2017, Mike Bostock, Mike Bostock, 1, 1, 2, 0, 5
Tue Feb 28 20:19:34 GMT 2017, Mike Bostock, Mike Bostock, 15, 13, 28, 0, 20
Sun Feb 19 17:07:47 GMT 2017, Mike Bostock, Mike Bostock, 4, 0, 4, 0, 33
Sun Feb 19 17:00:37 GMT 2017, Mike Bostock, Mike Bostock, 1, 1, 2, 0, 5
Sun Feb 19 17:00:16 GMT 2017, Mike Bostock, Mike Bostock, 1, 1, 2, 0, 14
Sun Feb 19 16:31:32 GMT 2017, Mike Bostock, Mike Bostock, 15, 15, 30, 0, 22
Sat Feb 18 17:18:16 GMT 2017, Mike Bostock, Mike Bostock, 9, 9, 18, 0, 41
Sat Feb 18 17:17:29 GMT 2017, Mike Bostock, Mike Bostock, 1, 1, 2, 0, 5
Sat Feb 18 17:17:25 GMT 2017, Mike Bostock, Mike Bostock, 2, 2, 4, 0, 28
Wed Feb 15 22:28:09 GMT 2017, Elena Glassman, Mike Bostock, 9, 9, 18, 0, 50
Sun Jan 29 05:37:09 GMT 2017, Mike Bostock, Mike Bostock, 1, 1, 2, 0, 5
Sun Jan 29 05:37:01 GMT 2017, Mike Bostock, Mike Bostock, 2, 1, 3, 0, 20
Thu Jan 26 21:07:18 GMT 2017, Mike Bostock, Mike Bostock, 353, 353, 706, 0, 15
Thu Jan 26 21:04:56 GMT 2017, Mike Bostock, Mike Bostock, 1, 4, 5, 0, 15
Thu Jan 26 19:57:08 GMT 2017, Micah Stubbs, GitHub, 3, 0, 3, 0, 220
Thu Jan 26 18:01:49 GMT 2017, David Ollerhead, Mike Bostock, 1, 1, 2, 0, 59
Mon Jan 23 18:49:16 GMT 2017, Mike Bostock, Mike Bostock, 1, 1, 2, 0, 5
Mon Jan 23 18:49:13 GMT 2017, Mike Bostock, Mike Bostock, 1, 1, 2, 0, 16
Fri Jan 20 23:14:39 GMT 2017, Mike Bostock, Mike Bostock, 1, 1, 2, 0, 27
Fri Jan 20 23:11:32 GMT 2017, Mike Bostock, Mike Bostock, 12, 0, 12, 0, 55
Fri Jan 20 23:09:13 GMT 2017, Mike Bostock, Mike Bostock, 1, 1, 2, 0, 5
Fri Jan 20 23:09:01 GMT 2017, Mike Bostock, Mike Bostock, 1, 6, 7, 0, 10
Wed Jan 18 10:00:38 GMT 2017, Mike Bostock, Mike Bostock, 1, 1, 2, 0, 5
Wed Jan 18 10:00:25 GMT 2017, Mike Bostock, Mike Bostock, 33, 478, 511, 4, 30
Fri Jan 06 17:12:26 GMT 2017, Mike Bostock, Mike Bostock, 1, 1, 2, 0, 5
Fri Jan 06 17:12:05 GMT 2017, Mike Bostock, Mike Bostock, 3, 3, 6, 0, 27
Wed Nov 23 01:31:45 GMT 2016, Mike Bostock, Mike Bostock, 1, 1, 2, 0, 5
Wed Nov 23 01:13:48 GMT 2016, Mike Bostock, Mike Bostock, 22, 22, 44, 0, 20
Tue Nov 22 02:53:45 GMT 2016, Peter Lenahan, Mike Bostock, 2, 2, 4, 0, 92
Fri Nov 04 14:55:27 GMT 2016, Mike van Rossum, Mike Bostock, 1, 1, 2, 0, 34
Fri Nov 04 14:34:27 GMT 2016, Mike van Rossum, Mike Bostock, 1, 1, 2, 0, 20
Wed Nov 02 22:32:05 GMT 2016, Mike Bostock, Mike Bostock, 12, 0, 12, 0, 14
Thu Oct 27 19:53:45 BST 2016, Mike Bostock, Mike Bostock, 61, 44, 105, 0, 25
Thu Oct 27 19:43:19 BST 2016, Mike Bostock, Mike Bostock, 1, 1, 2, 0, 5
Thu Oct 27 19:43:10 BST 2016, Mike Bostock, Mike Bostock, 5, 3, 8, 0, 20
Thu Oct 20 18:51:07 BST 2016, Mike Bostock, Mike Bostock, 3, 3, 6, 0, 41
Thu Oct 20 18:50:30 BST 2016, Mike Bostock, Mike Bostock, 1, 1, 2, 0, 5
Thu Oct 20 18:49:59 BST 2016, Mike Bostock, Mike Bostock, 1, 1, 2, 0, 20
Wed Oct 19 22:43:25 BST 2016, Mike Bostock, GitHub, 3, 3, 6, 0, 30
Tue Oct 11 16:54:56 BST 2016, Mike Bostock, Mike Bostock, 1, 1, 2, 0, 5
Tue Oct 11 16:54:51 BST 2016, Mike Bostock, Mike Bostock, 2, 2, 4, 0, 20
Fri Oct 07 17:09:57 BST 2016, Mike Bostock, Mike Bostock, 9, 0, 9, 0, 37
Thu Sep 22 18:30:22 BST 2016, Mike Bostock, Mike Bostock, 1, 1, 2, 0, 5
Thu Sep 22 18:30:06 BST 2016, Mike Bostock, Mike Bostock, 1, 1, 2, 0, 15
Tue Sep 20 21:12:56 BST 2016, Mike Bostock, Mike Bostock, 1, 1, 2, 0, 5
Tue Sep 20 21:12:52 BST 2016, Mike Bostock, Mike Bostock, 1, 1, 2, 0, 14
Mon Sep 19 21:43:03 BST 2016, Fábio Silva, Mike Bostock, 1, 1, 2, 0, 35
Mon Sep 19 19:55:44 BST 2016, Mike Bostock, Mike Bostock, 1, 1, 2, 0, 5
Mon Sep 19 19:55:39 BST 2016, Mike Bostock, Mike Bostock, 2, 2, 4, 0, 20
Mon Sep 19 19:54:01 BST 2016, Mike Bostock, Mike Bostock, 0, 0, 0, 0, 16
Mon Sep 19 17:11:00 BST 2016, Mike Bostock, Mike Bostock, 3, 4, 7, 0, 10
Mon Sep 19 16:52:43 BST 2016, Mike Bostock, Mike Bostock, 28, 0, 28, 0, 38
Tue Sep 13 00:35:35 BST 2016, Mike Bostock, Mike Bostock, 1, 1, 2, 0, 5
Tue Sep 13 00:35:30 BST 2016, Mike Bostock, Mike Bostock, 9, 9, 18, 0, 20
Sun Sep 11 15:56:34 BST 2016, Mike Bostock, Mike Bostock, 2, 2, 4, 0, 37
Tue Aug 30 20:26:38 BST 2016, Mike Bostock, Mike Bostock, 1, 1, 2, 0, 14
Tue Aug 30 20:25:30 BST 2016, Mike Bostock, Mike Bostock, 4, 4, 8, 0, 60
Tue Aug 30 17:46:24 BST 2016, Jeferson Koslowski, Jeferson Koslowski, 4, 4, 8, 0, 239
Tue Aug 16 05:21:49 BST 2016, Mike Bostock, Mike Bostock, 1, 1, 2, 0, 20
Tue Aug 16 05:19:25 BST 2016, Mike Bostock, Mike Bostock, 1, 1, 2, 0, 5
Tue Aug 16 05:19:18 BST 2016, Mike Bostock, Mike Bostock, 1, 1, 2, 0, 14
Thu Aug 11 16:47:25 BST 2016, Mike Bostock, Mike Bostock, 1, 0, 1, 0, 23
Sun Aug 07 15:58:26 BST 2016, Mike Bostock, Mike Bostock, 1, 1, 2, 0, 14
Sun Aug 07 15:52:32 BST 2016, Mike Bostock, Mike Bostock, 2, 2, 4, 0, 14
Sun Aug 07 15:51:27 BST 2016, Mike Bostock, Mike Bostock, 2, 2, 4, 0, 14
Sun Aug 07 15:50:53 BST 2016, Mike Bostock, Mike Bostock, 1, 3, 4, 0, 14
Sun Aug 07 15:49:47 BST 2016, Mike Bostock, Mike Bostock, 13, 1, 14, 0, 14
Wed Aug 03 01:42:13 BST 2016, Mike Bostock, Mike Bostock, 1, 1, 2, 0, 5
Wed Aug 03 01:42:07 BST 2016, Mike Bostock, Mike Bostock, 38, 57, 95, 0, 34
Sat Jul 30 00:02:36 BST 2016, Mike Bostock, Mike Bostock, 1, 1, 2, 0, 5
Sat Jul 30 00:02:32 BST 2016, Mike Bostock, Mike Bostock, 14, 12, 26, 0, 20
Fri Jul 29 14:50:44 BST 2016, Mike Bostock, Mike Bostock, 1, 1, 2, 0, 15
Tue Jul 26 21:30:38 BST 2016, Barrie Treloar, Mike Bostock, 1, 1, 2, 0, 30
Sat Jul 23 12:33:25 BST 2016, william-pan, Mike Bostock, 2, 2, 4, 0, 47
Mon Jul 18 19:56:57 BST 2016, Mike Bostock, Mike Bostock, 1, 1, 2, 0, 15
Mon Jul 18 19:54:59 BST 2016, Mike Bostock, Mike Bostock, 5, 5, 10, 0, 61
Mon Jul 18 17:57:27 BST 2016, Gordon Woodhull, Gordon Woodhull, 6, 6, 12, 0, 304
Thu Jul 14 00:44:59 BST 2016, Dev-Lan, Mike Bostock, 1, 1, 2, 1, 40
Mon Jul 11 03:47:51 BST 2016, Mike Bostock, Mike Bostock, 1, 1, 2, 0, 5
Mon Jul 11 03:47:46 BST 2016, Mike Bostock, Mike Bostock, 5, 5, 10, 0, 20
Fri Jul 08 23:50:10 BST 2016, Mike Bostock, Mike Bostock, 8, 0, 8, 0, 47
Sat Jul 02 06:27:51 BST 2016, Mike Bostock, Mike Bostock, 1, 1, 2, 0, 5
Fri Jul 01 22:10:07 BST 2016, Mike Bostock, Mike Bostock, 44, 17, 61, 0, 20
Fri Jul 01 22:02:24 BST 2016, Mike Bostock, Mike Bostock, 9, 29, 38, 1, 29
Fri Jul 01 14:59:51 BST 2016, Curran Kelleher, Mike Bostock, 1, 1, 2, 0, 53
Thu Jun 30 16:56:07 BST 2016, Mike Bostock, Mike Bostock, 2, 0, 2, 0, 15
Thu Jun 30 01:16:54 BST 2016, Mike Bostock, Mike Bostock, 1, 1, 2, 0, 37
Tue Jun 28 16:02:50 BST 2016, Mike Bostock, Mike Bostock, 1, 1, 2, 0, 18
Tue Jun 28 16:01:50 BST 2016, Mike Bostock, Mike Bostock, 1, 1, 2, 1, 5
Tue Jun 28 16:00:33 BST 2016, Mike Bostock, Mike Bostock, 13, 16, 29, 0, 26
Mon Jun 27 23:10:27 BST 2016, Mike Bostock, Mike Bostock, 1, 1, 2, 0, 11
Mon Jun 27 23:09:09 BST 2016, Mike Bostock, Mike Bostock, 1, 1, 2, 0, 26
Mon Jun 27 19:47:41 BST 2016, Mike Bostock, Mike Bostock, 900, 900, 1800, 0, 24
Mon Jun 27 19:28:46 BST 2016, Mike Bostock, GitHub, 57, 57, 114, 0, 79
Mon Jun 27 19:22:20 BST 2016, mpersing, GitHub, 57, 57, 114, 0, 31
Sat Jun 25 22:19:18 BST 2016, Mike Bostock, Mike Bostock, 25, 25, 50, 0, 11
Sat Jun 25 22:15:40 BST 2016, Mike Bostock, Mike Bostock, 11, 11, 22, 0, 11
Sat Jun 25 22:13:34 BST 2016, Mike Bostock, Mike Bostock, 6, 6, 12, 0, 11
Sat Jun 25 22:12:27 BST 2016, Mike Bostock, Mike Bostock, 5, 5, 10, 0, 11
Sat Jun 25 22:11:00 BST 2016, Mike Bostock, Mike Bostock, 64, 64, 128, 0, 11
Sat Jun 25 21:48:51 BST 2016, Mike Bostock, Mike Bostock, 1, 3, 4, 0, 15
Sat Jun 25 17:32:52 BST 2016, Mike Bostock, Mike Bostock, 6, 5, 11, 0, 11
Sat Jun 25 17:31:50 BST 2016, Mike Bostock, Mike Bostock, 11, 0, 11, 0, 11
Sat Jun 25 17:27:16 BST 2016, Mike Bostock, Mike Bostock, 1, 0, 1, 0, 11
Sat Jun 25 17:23:06 BST 2016, Mike Bostock, Mike Bostock, 2, 2, 4, 0, 11
Sat Jun 25 17:21:20 BST 2016, Mike Bostock, Mike Bostock, 14, 14, 28, 0, 11
Sat Jun 25 17:20:23 BST 2016, Mike Bostock, Mike Bostock, 34, 10, 44, 0, 11
Sat Jun 25 17:10:38 BST 2016, Mike Bostock, Mike Bostock, 16, 15, 31, 0, 11
Sat Jun 25 17:09:27 BST 2016, Mike Bostock, Mike Bostock, 1, 4, 5, 0, 11
Sat Jun 25 17:07:29 BST 2016, Mike Bostock, Mike Bostock, 19, 19, 38, 0, 11
Sat Jun 25 17:03:51 BST 2016, Mike Bostock, Mike Bostock, 38, 25, 63, 0, 11
Sat Jun 25 16:16:09 BST 2016, Mike Bostock, Mike Bostock, 7, 7, 14, 0, 23
Sat Jun 25 00:34:00 BST 2016, Mike Bostock, Mike Bostock, 23, 21, 44, 0, 24
Fri Jun 24 18:29:30 BST 2016, Mike Bostock, Mike Bostock, 1, 3, 4, 0, 15
Fri Jun 24 18:24:55 BST 2016, Mike Bostock, Mike Bostock, 2, 2, 4, 0, 15
Fri Jun 24 18:24:37 BST 2016, Mike Bostock, Mike Bostock, 2, 2, 4, 0, 15
Fri Jun 24 18:24:02 BST 2016, Mike Bostock, Mike Bostock, 36, 11, 47, 0, 15
Fri Jun 24 18:15:15 BST 2016, Mike Bostock, Mike Bostock, 1, 3, 4, 0, 15
Fri Jun 24 18:14:29 BST 2016, Mike Bostock, Mike Bostock, 2, 2, 4, 0, 15
Fri Jun 24 18:13:24 BST 2016, Mike Bostock, Mike Bostock, 7, 1, 8, 0, 15
Fri Jun 24 18:11:57 BST 2016, Mike Bostock, Mike Bostock, 2, 4, 6, 0, 15
Fri Jun 24 18:09:19 BST 2016, Mike Bostock, Mike Bostock, 18, 10, 28, 0, 15
Fri Jun 24 18:00:15 BST 2016, Mike Bostock, Mike Bostock, 1, 3, 4, 0, 15
Fri Jun 24 17:59:57 BST 2016, Mike Bostock, Mike Bostock, 18, 20, 38, 0, 15
Fri Jun 24 17:45:19 BST 2016, Mike Bostock, Mike Bostock, 24, 22, 46, 0, 15
Fri Jun 24 17:29:34 BST 2016, Mike Bostock, Mike Bostock, 1, 1, 2, 0, 14
Fri Jun 24 17:26:47 BST 2016, Mike Bostock, Mike Bostock, 29, 14, 43, 0, 15
Fri Jun 24 17:12:28 BST 2016, Mike Bostock, Mike Bostock, 17, 8, 25, 0, 14
Fri Jun 24 16:47:50 BST 2016, Mike Bostock, Mike Bostock, 5, 0, 5, 0, 11
Fri Jun 24 05:41:34 BST 2016, Mike Bostock, Mike Bostock, 2, 4, 6, 0, 15
Fri Jun 24 05:38:11 BST 2016, Mike Bostock, Mike Bostock, 24, 19, 43, 0, 15
Fri Jun 24 02:01:10 BST 2016, Mike Bostock, Mike Bostock, 16, 4, 20, 0, 15
Fri Jun 24 01:56:26 BST 2016, Mike Bostock, Mike Bostock, 15, 1, 16, 0, 15
Fri Jun 24 01:55:03 BST 2016, Mike Bostock, Mike Bostock, 1, 1, 2, 0, 15
Fri Jun 24 01:54:35 BST 2016, Mike Bostock, Mike Bostock, 1, 1, 2, 0, 15
Fri Jun 24 01:53:29 BST 2016, Mike Bostock, Mike Bostock, 8, 10, 18, 0, 15
Fri Jun 24 01:36:45 BST 2016, Mike Bostock, Mike Bostock, 29, 24, 53, 0, 15
Fri Jun 24 01:30:11 BST 2016, Mike Bostock, Mike Bostock, 2, 2, 4, 0, 15
Fri Jun 24 01:28:11 BST 2016, Mike Bostock, Mike Bostock, 1, 1, 2, 0, 15
Fri Jun 24 01:27:25 BST 2016, Mike Bostock, Mike Bostock, 1, 1, 2, 0, 15
Fri Jun 24 01:26:57 BST 2016, Mike Bostock, Mike Bostock, 1, 1, 2, 0, 15
Fri Jun 24 01:26:48 BST 2016, Mike Bostock, Mike Bostock, 1, 1, 2, 0, 15
Fri Jun 24 01:15:13 BST 2016, Mike Bostock, Mike Bostock, 2, 2, 4, 0, 15
Fri Jun 24 01:13:46 BST 2016, Mike Bostock, Mike Bostock, 1, 1, 2, 0, 15
Fri Jun 24 01:13:03 BST 2016, Mike Bostock, Mike Bostock, 2, 2, 4, 0, 15
Fri Jun 24 01:12:09 BST 2016, Mike Bostock, Mike Bostock, 2, 4, 6, 0, 15
Fri Jun 24 01:11:27 BST 2016, Mike Bostock, Mike Bostock, 1, 3, 4, 0, 15
Fri Jun 24 01:10:15 BST 2016, Mike Bostock, Mike Bostock, 10, 8, 18, 0, 15
Fri Jun 24 01:04:31 BST 2016, Mike Bostock, Mike Bostock, 33, 36, 69, 0, 15
Fri Jun 24 01:02:54 BST 2016, Mike Bostock, Mike Bostock, 1, 1, 2, 0, 11
Fri Jun 24 01:00:49 BST 2016, Mike Bostock, Mike Bostock, 1105, 1099, 2204, 0, 33
Fri Jun 24 00:56:24 BST 2016, Mike Bostock, Mike Bostock, 3, 1, 4, 0, 15
Thu Jun 23 23:37:41 BST 2016, Mike Bostock, Mike Bostock, 2, 2, 4, 0, 15
Thu Jun 23 23:35:53 BST 2016, Mike Bostock, Mike Bostock, 1, 3, 4, 0, 15
Thu Jun 23 23:35:06 BST 2016, Mike Bostock, Mike Bostock, 3, 3, 6, 0, 15
Thu Jun 23 23:33:35 BST 2016, Mike Bostock, Mike Bostock, 53, 9, 62, 0, 15
Thu Jun 23 23:20:55 BST 2016, Mike Bostock, Mike Bostock, 40, 15, 55, 0, 15
Thu Jun 23 23:13:17 BST 2016, Mike Bostock, Mike Bostock, 1, 1, 2, 0, 15
Thu Jun 23 23:13:05 BST 2016, Mike Bostock, Mike Bostock, 2, 2, 4, 0, 15
Thu Jun 23 23:11:47 BST 2016, Mike Bostock, Mike Bostock, 2, 2, 4, 0, 15
Thu Jun 23 23:10:20 BST 2016, Mike Bostock, Mike Bostock, 3, 3, 6, 0, 15
Thu Jun 23 23:03:58 BST 2016, Mike Bostock, Mike Bostock, 3, 3, 6, 0, 15
Thu Jun 23 23:03:27 BST 2016, Mike Bostock, Mike Bostock, 12, 2, 14, 0, 15
Thu Jun 23 23:02:34 BST 2016, Mike Bostock, Mike Bostock, 1, 8, 9, 0, 15
Thu Jun 23 23:01:22 BST 2016, Mike Bostock, Mike Bostock, 15, 6, 21, 0, 15
Thu Jun 23 22:05:45 BST 2016, Mike Bostock, Mike Bostock, 1, 1, 2, 0, 15
Thu Jun 23 22:02:59 BST 2016, Mike Bostock, Mike Bostock, 9, 0, 9, 0, 15
Thu Jun 23 05:36:43 BST 2016, Mike Bostock, Mike Bostock, 17, 14, 31, 0, 15
Wed Jun 22 23:53:40 BST 2016, Mike Bostock, Mike Bostock, 2, 2, 4, 0, 15
Wed Jun 22 23:53:25 BST 2016, Mike Bostock, Mike Bostock, 2, 2, 4, 0, 15
Wed Jun 22 23:53:02 BST 2016, Mike Bostock, Mike Bostock, 20, 15, 35, 0, 15
Wed Jun 22 21:29:40 BST 2016, Mike Bostock, Mike Bostock, 2, 4, 6, 0, 15
Wed Jun 22 21:13:58 BST 2016, Mike Bostock, Mike Bostock, 1, 1, 2, 0, 15
Wed Jun 22 21:13:45 BST 2016, Mike Bostock, Mike Bostock, 2, 2, 4, 0, 15
Wed Jun 22 21:08:50 BST 2016, Mike Bostock, Mike Bostock, 6, 4, 10, 0, 15
Wed Jun 22 21:08:49 BST 2016, Mike Bostock, Mike Bostock, 0, 0, 0, 3, 16
Wed Jun 22 20:55:06 BST 2016, Mike Bostock, Mike Bostock, 1, 1, 2, 0, 15
Wed Jun 22 20:54:37 BST 2016, Mike Bostock, Mike Bostock, 1, 1, 2, 0, 15
Wed Jun 22 20:54:29 BST 2016, Mike Bostock, Mike Bostock, 1, 1, 2, 0, 15
Wed Jun 22 20:53:53 BST 2016, Mike Bostock, Mike Bostock, 7, 12, 19, 0, 15
Wed Jun 22 20:44:08 BST 2016, Mike Bostock, Mike Bostock, 2, 2, 4, 0, 15
Wed Jun 22 20:43:13 BST 2016, Mike Bostock, Mike Bostock, 6, 4, 10, 0, 15
Wed Jun 22 20:25:04 BST 2016, Mike Bostock, Mike Bostock, 6, 8, 14, 0, 15
Wed Jun 22 19:56:38 BST 2016, Mike Bostock, Mike Bostock, 1, 1, 2, 0, 15
Wed Jun 22 19:56:34 BST 2016, Mike Bostock, Mike Bostock, 1, 1, 2, 0, 15
Wed Jun 22 19:56:29 BST 2016, Mike Bostock, Mike Bostock, 1, 1, 2, 0, 15
Wed Jun 22 19:53:46 BST 2016, Mike Bostock, Mike Bostock, 1, 1, 2, 0, 15
Wed Jun 22 19:52:05 BST 2016, Mike Bostock, Mike Bostock, 1, 2, 3, 0, 15
Wed Jun 22 19:50:40 BST 2016, Mike Bostock, Mike Bostock, 1, 1, 2, 0, 15
Wed Jun 22 19:49:52 BST 2016, Mike Bostock, Mike Bostock, 59, 23, 82, 0, 15
Wed Jun 22 19:48:49 BST 2016, Mike Bostock, Mike Bostock, 0, 0, 0, 0, 17
Wed Jun 22 18:50:11 BST 2016, Mike Bostock, Mike Bostock, 1, 0, 1, 0, 15
Wed Jun 22 18:48:38 BST 2016, Mike Bostock, Mike Bostock, 6, 4, 10, 0, 15
Wed Jun 22 05:26:34 BST 2016, Mike Bostock, Mike Bostock, 1, 1, 2, 0, 15
Wed Jun 22 05:26:23 BST 2016, Mike Bostock, Mike Bostock, 1, 1, 2, 0, 15
Wed Jun 22 05:24:44 BST 2016, Mike Bostock, Mike Bostock, 2, 8, 10, 0, 15
Wed Jun 22 00:55:40 BST 2016, Mike Bostock, Mike Bostock, 12, 7, 19, 0, 15
Tue Jun 21 23:23:57 BST 2016, Mike Bostock, Mike Bostock, 40, 51, 91, 0, 15
Tue Jun 21 22:50:03 BST 2016, Mike Bostock, Mike Bostock, 4, 4, 8, 0, 15
Tue Jun 21 22:47:46 BST 2016, Mike Bostock, Mike Bostock, 39, 20, 59, 0, 15
Tue Jun 21 19:38:30 BST 2016, Mike Bostock, Mike Bostock, 4, 4, 8, 0, 15
Tue Jun 21 19:35:39 BST 2016, Mike Bostock, Mike Bostock, 12, 6, 18, 0, 15
Tue Jun 21 19:20:42 BST 2016, Mike Bostock, Mike Bostock, 32, 1, 33, 0, 15
Mon Jun 20 23:41:00 BST 2016, Mike Bostock, Mike Bostock, 1, 3, 4, 0, 15
Mon Jun 20 23:40:26 BST 2016, Mike Bostock, Mike Bostock, 1, 1, 2, 0, 15
Mon Jun 20 23:40:09 BST 2016, Mike Bostock, Mike Bostock, 1, 1, 2, 0, 15
Mon Jun 20 23:39:50 BST 2016, Mike Bostock, Mike Bostock, 2, 2, 4, 0, 15
Mon Jun 20 23:39:08 BST 2016, Mike Bostock, Mike Bostock, 1, 1, 2, 0, 15
Mon Jun 20 23:38:42 BST 2016, Mike Bostock, Mike Bostock, 1, 1, 2, 0, 15
Mon Jun 20 23:38:15 BST 2016, Mike Bostock, Mike Bostock, 1, 1, 2, 0, 15
Mon Jun 20 23:36:20 BST 2016, Mike Bostock, Mike Bostock, 8, 34, 42, 0, 15
Mon Jun 20 20:32:58 BST 2016, Mike Bostock, Mike Bostock, 9, 24, 33, 0, 15
Mon Jun 20 20:11:31 BST 2016, Mike Bostock, Mike Bostock, 1, 1, 2, 0, 15
Mon Jun 20 20:11:10 BST 2016, Mike Bostock, Mike Bostock, 3, 3, 6, 0, 15
Mon Jun 20 20:09:10 BST 2016, Mike Bostock, Mike Bostock, 7, 12, 19, 0, 15
Mon Jun 20 19:47:13 BST 2016, Mike Bostock, Mike Bostock, 1, 1, 2, 0, 15
Mon Jun 20 19:43:39 BST 2016, Mike Bostock, Mike Bostock, 1, 1, 2, 0, 15
Mon Jun 20 19:42:44 BST 2016, Mike Bostock, Mike Bostock, 1, 3, 4, 0, 15
Mon Jun 20 19:40:43 BST 2016, Mike Bostock, Mike Bostock, 20, 15, 35, 0, 15
Sun Jun 19 18:03:18 BST 2016, Mike Bostock, Mike Bostock, 6, 8, 14, 0, 14
Sun Jun 19 17:54:00 BST 2016, Mike Bostock, Mike Bostock, 5, 5, 10, 0, 14
Sun Jun 19 17:52:30 BST 2016, Mike Bostock, Mike Bostock, 115, 27, 142, 0, 32
Thu Jun 16 00:21:40 BST 2016, Mike Bostock, Mike Bostock, 2, 2, 4, 0, 15
Thu Jun 16 00:19:34 BST 2016, Mike Bostock, Mike Bostock, 6, 10, 16, 0, 15
Wed Jun 15 19:42:50 BST 2016, Mike Bostock, Mike Bostock, 4, 4, 8, 0, 15
Wed Jun 15 19:41:22 BST 2016, Mike Bostock, Mike Bostock, 1, 1, 2, 0, 15
Wed Jun 15 19:41:07 BST 2016, Mike Bostock, Mike Bostock, 1, 1, 2, 0, 15
Wed Jun 15 19:40:11 BST 2016, Mike Bostock, Mike Bostock, 34, 13, 47, 0, 15
Wed Jun 15 18:55:15 BST 2016, Mike Bostock, Mike Bostock, 4, 8, 12, 0, 15
Wed Jun 15 18:07:35 BST 2016, Mike Bostock, Mike Bostock, 0, 2, 2, 0, 15
Wed Jun 15 18:06:57 BST 2016, Mike Bostock, Mike Bostock, 1, 1, 2, 0, 14
Wed Jun 15 17:30:05 BST 2016, Mike Bostock, Mike Bostock, 3, 3, 6, 0, 15
Wed Jun 15 17:29:33 BST 2016, Mike Bostock, Mike Bostock, 7, 9, 16, 0, 15
Wed Jun 15 17:23:58 BST 2016, Mike Bostock, Mike Bostock, 21, 31, 52, 0, 15
Wed Jun 15 16:52:32 BST 2016, Mike Bostock, Mike Bostock, 1, 1, 2, 0, 15
Wed Jun 15 16:55:36 BST 2016, Mike Bostock, Mike Bostock, 8, 4, 12, 0, 15
Wed Jun 15 00:32:08 BST 2016, Mike Bostock, Mike Bostock, 2, 2, 4, 0, 15
Wed Jun 15 00:30:42 BST 2016, Mike Bostock, Mike Bostock, 1, 1, 2, 0, 15
Wed Jun 15 00:30:26 BST 2016, Mike Bostock, Mike Bostock, 2, 2, 4, 0, 15
Wed Jun 15 00:28:49 BST 2016, Mike Bostock, Mike Bostock, 49, 21, 70, 0, 15
Wed Jun 15 00:13:36 BST 2016, Mike Bostock, Mike Bostock, 1, 1, 2, 0, 15
Wed Jun 15 00:12:49 BST 2016, Mike Bostock, Mike Bostock, 119, 95, 214, 0, 15
Tue Jun 14 21:59:31 BST 2016, Mike Bostock, Mike Bostock, 47, 57, 104, 0, 15
Tue Jun 14 21:42:30 BST 2016, Mike Bostock, Mike Bostock, 1, 1, 2, 0, 15
Tue Jun 14 21:41:50 BST 2016, Mike Bostock, Mike Bostock, 2, 7, 9, 0, 15
Tue Jun 14 21:39:08 BST 2016, Mike Bostock, Mike Bostock, 7, 8, 15, 0, 15
Tue Jun 14 21:35:31 BST 2016, Mike Bostock, Mike Bostock, 17, 2, 19, 0, 15
Tue Jun 14 21:30:47 BST 2016, Mike Bostock, Mike Bostock, 2, 2, 4, 0, 15
Tue Jun 14 21:29:14 BST 2016, Mike Bostock, Mike Bostock, 1, 1, 2, 0, 15
Tue Jun 14 21:28:57 BST 2016, Mike Bostock, Mike Bostock, 2, 2, 4, 0, 15
Tue Jun 14 21:28:20 BST 2016, Mike Bostock, Mike Bostock, 3, 3, 6, 0, 15
Tue Jun 14 21:27:07 BST 2016, Mike Bostock, Mike Bostock, 54, 8, 62, 0, 15
Tue Jun 14 20:48:52 BST 2016, Mike Bostock, Mike Bostock, 3, 3, 6, 0, 15
Tue Jun 14 20:47:49 BST 2016, Mike Bostock, Mike Bostock, 61, 55, 116, 0, 15
Tue Jun 14 19:44:08 BST 2016, Mike Bostock, Mike Bostock, 2, 2, 4, 0, 15
Tue Jun 14 19:24:29 BST 2016, Mike Bostock, Mike Bostock, 1, 1, 2, 0, 15
Tue Jun 14 19:21:51 BST 2016, Mike Bostock, Mike Bostock, 27, 25, 52, 0, 15
Tue Jun 14 19:02:07 BST 2016, Mike Bostock, Mike Bostock, 17, 11, 28, 0, 15
Tue Jun 14 18:52:56 BST 2016, Mike Bostock, Mike Bostock, 1, 3, 4, 0, 15
Tue Jun 14 18:28:04 BST 2016, Mike Bostock, Mike Bostock, 3, 2, 5, 0, 15
Tue Jun 14 18:15:15 BST 2016, Mike Bostock, Mike Bostock, 13, 13, 26, 0, 15
Tue Jun 14 18:10:18 BST 2016, Mike Bostock, Mike Bostock, 5, 3, 8, 0, 15
Tue Jun 14 18:08:09 BST 2016, Mike Bostock, Mike Bostock, 1, 3, 4, 0, 15
Tue Jun 14 18:07:35 BST 2016, Mike Bostock, Mike Bostock, 71, 9, 80, 0, 15
Tue Jun 14 17:45:46 BST 2016, Mike Bostock, Mike Bostock, 0, 1, 1, 0, 15
Tue Jun 14 00:56:53 BST 2016, Mike Bostock, Mike Bostock, 1, 0, 1, 0, 15
Tue Jun 14 00:16:16 BST 2016, Mike Bostock, Mike Bostock, 14, 14, 28, 0, 15
Tue Jun 14 00:09:15 BST 2016, Mike Bostock, Mike Bostock, 1, 11, 12, 0, 15
Tue Jun 14 00:05:32 BST 2016, Mike Bostock, Mike Bostock, 2, 2, 4, 0, 15
Tue Jun 14 00:04:19 BST 2016, Mike Bostock, Mike Bostock, 3, 5, 8, 0, 15
Tue Jun 14 00:03:44 BST 2016, Mike Bostock, Mike Bostock, 2, 2, 4, 0, 15
Tue Jun 14 00:03:18 BST 2016, Mike Bostock, Mike Bostock, 54, 36, 90, 0, 15
Mon Jun 13 23:47:27 BST 2016, Mike Bostock, Mike Bostock, 1, 1, 2, 0, 15
Mon Jun 13 23:47:09 BST 2016, Mike Bostock, Mike Bostock, 3, 3, 6, 0, 15
Mon Jun 13 23:46:22 BST 2016, Mike Bostock, Mike Bostock, 1, 3, 4, 0, 15
Mon Jun 13 23:46:06 BST 2016, Mike Bostock, Mike Bostock, 3, 1, 4, 0, 15
Mon Jun 13 23:45:28 BST 2016, Mike Bostock, Mike Bostock, 20, 13, 33, 0, 15
Mon Jun 13 22:32:09 BST 2016, Mike Bostock, Mike Bostock, 1, 0, 1, 0, 15
Mon Jun 13 22:30:42 BST 2016, Mike Bostock, Mike Bostock, 1, 1, 2, 0, 15
Mon Jun 13 22:29:44 BST 2016, Mike Bostock, Mike Bostock, 2, 2, 4, 0, 15
Mon Jun 13 22:29:08 BST 2016, Mike Bostock, Mike Bostock, 23, 9, 32, 0, 15
Mon Jun 13 22:16:22 BST 2016, Mike Bostock, Mike Bostock, 3, 3, 6, 0, 15
Mon Jun 13 22:14:43 BST 2016, Mike Bostock, Mike Bostock, 7, 1, 8, 0, 15
Mon Jun 13 22:13:06 BST 2016, Mike Bostock, Mike Bostock, 2, 2, 4, 0, 15
Mon Jun 13 22:12:09 BST 2016, Mike Bostock, Mike Bostock, 6, 23, 29, 0, 15
Mon Jun 13 21:34:16 BST 2016, Mike Bostock, Mike Bostock, 6, 6, 12, 0, 15
Mon Jun 13 21:26:31 BST 2016, Mike Bostock, Mike Bostock, 20, 8, 28, 0, 15
Mon Jun 13 21:22:07 BST 2016, Mike Bostock, Mike Bostock, 1, 1, 2, 0, 15
Mon Jun 13 21:20:12 BST 2016, Mike Bostock, Mike Bostock, 2, 2, 4, 0, 15
Mon Jun 13 21:18:30 BST 2016, Mike Bostock, Mike Bostock, 1, 1, 2, 0, 15
Mon Jun 13 21:18:05 BST 2016, Mike Bostock, Mike Bostock, 7, 14, 21, 0, 15
Mon Jun 13 20:36:08 BST 2016, Mike Bostock, Mike Bostock, 0, 1, 1, 0, 15
Mon Jun 13 20:35:38 BST 2016, Mike Bostock, Mike Bostock, 2, 2, 4, 0, 15
Mon Jun 13 20:34:17 BST 2016, Mike Bostock, Mike Bostock, 0, 7, 7, 0, 15
Mon Jun 13 20:31:48 BST 2016, Mike Bostock, Mike Bostock, 19, 0, 19, 0, 15
Mon Jun 13 20:16:42 BST 2016, Mike Bostock, Mike Bostock, 8, 0, 8, 0, 15
Mon Jun 13 20:08:44 BST 2016, Mike Bostock, Mike Bostock, 3, 0, 3, 0, 15
Mon Jun 13 20:06:16 BST 2016, Mike Bostock, Mike Bostock, 19, 3, 22, 0, 15
Mon Jun 13 19:50:28 BST 2016, Mike Bostock, Mike Bostock, 64, 45, 109, 0, 15
Mon Jun 13 19:43:33 BST 2016, Mike Bostock, Mike Bostock, 5, 2, 7, 0, 15
Mon Jun 13 19:40:15 BST 2016, Mike Bostock, Mike Bostock, 6, 0, 6, 0, 15
Mon Jun 13 19:40:06 BST 2016, Mike Bostock, GitHub, 1, 1, 2, 0, 81
Mon Jun 13 19:36:34 BST 2016, Curran Kelleher, GitHub, 1, 1, 2, 0, 107
Mon Jun 13 19:29:42 BST 2016, Mike Bostock, GitHub, 1, 1, 2, 0, 78
Mon Jun 13 19:29:10 BST 2016, Mike Bostock, Mike Bostock, 62, 2, 64, 0, 15
Mon Jun 13 19:25:02 BST 2016, Curran Kelleher, GitHub, 1, 1, 2, 0, 248
Mon Jun 13 19:10:56 BST 2016, Mike Bostock, Mike Bostock, 25, 4, 29, 0, 15
Mon Jun 13 17:02:13 BST 2016, Mike Bostock, Mike Bostock, 57, 51, 108, 0, 15
Sat Jun 11 16:47:20 BST 2016, Mike Bostock, Mike Bostock, 34, 3, 37, 0, 15
Sat Jun 11 06:17:49 BST 2016, Mike Bostock, Mike Bostock, 18, 12, 30, 0, 15
Sat Jun 11 01:16:16 BST 2016, Mike Bostock, Mike Bostock, 20, 0, 20, 0, 15
Sat Jun 11 00:57:22 BST 2016, Mike Bostock, Mike Bostock, 36, 1, 37, 0, 15
Sat Jun 11 00:40:10 BST 2016, Mike Bostock, Mike Bostock, 66, 6, 72, 0, 15
Fri Jun 10 23:10:17 BST 2016, Mike Bostock, Mike Bostock, 1, 1, 2, 0, 15
Fri Jun 10 23:09:57 BST 2016, Mike Bostock, Mike Bostock, 1, 1, 2, 0, 15
Fri Jun 10 23:05:55 BST 2016, Mike Bostock, Mike Bostock, 12, 0, 12, 0, 15
Fri Jun 10 22:58:26 BST 2016, Mike Bostock, Mike Bostock, 32, 30, 62, 0, 15
Fri Jun 10 22:43:08 BST 2016, Mike Bostock, Mike Bostock, 60, 22, 82, 0, 15
Fri Jun 10 22:17:32 BST 2016, Mike Bostock, Mike Bostock, 65, 1, 66, 0, 15
Fri Jun 10 18:04:32 BST 2016, Mike Bostock, Mike Bostock, 5, 5, 10, 0, 9
Fri Jun 10 17:58:01 BST 2016, Mike Bostock, Mike Bostock, 7, 7, 14, 0, 9
Fri Jun 10 17:11:37 BST 2016, Mike Bostock, Mike Bostock, 5, 5, 10, 0, 9
Fri Jun 10 16:52:03 BST 2016, Mike Bostock, Mike Bostock, 7, 7, 14, 0, 9
Fri Jun 10 01:42:59 BST 2016, Mike Bostock, Mike Bostock, 11, 1, 12, 0, 15
Fri Jun 10 01:26:52 BST 2016, Mike Bostock, Mike Bostock, 17, 2, 19, 0, 15
Fri Jun 10 01:05:19 BST 2016, Mike Bostock, Mike Bostock, 1, 1, 2, 0, 15
Fri Jun 10 01:03:45 BST 2016, Mike Bostock, Mike Bostock, 2, 2, 4, 0, 15
Fri Jun 10 01:01:51 BST 2016, Mike Bostock, Mike Bostock, 64, 38, 102, 0, 15
Fri Jun 10 00:54:31 BST 2016, Mike Bostock, Mike Bostock, 76, 8, 84, 0, 15
Thu Jun 09 23:28:39 BST 2016, Mike Bostock, Mike Bostock, 17, 0, 17, 0, 15
Thu Jun 09 23:21:11 BST 2016, Mike Bostock, Mike Bostock, 2, 5, 7, 0, 15
Thu Jun 09 23:16:20 BST 2016, Mike Bostock, Mike Bostock, 7, 11, 18, 0, 15
Thu Jun 09 23:02:03 BST 2016, Mike Bostock, Mike Bostock, 1, 1, 2, 0, 15
Thu Jun 09 22:56:11 BST 2016, Mike Bostock, Mike Bostock, 51, 3, 54, 0, 15
Thu Jun 09 22:54:45 BST 2016, Mike Bostock, Mike Bostock, 0, 0, 0, 0, 11
Thu Jun 09 22:44:51 BST 2016, Mike Bostock, Mike Bostock, 1, 3, 4, 2, 15
Thu Jun 09 22:43:38 BST 2016, Mike Bostock, Mike Bostock, 1, 5, 6, 0, 15
Thu Jun 09 22:43:12 BST 2016, Mike Bostock, Mike Bostock, 26, 5, 31, 0, 15
Thu Jun 09 22:22:18 BST 2016, Mike Bostock, Mike Bostock, 6, 4, 10, 0, 15
Thu Jun 09 21:10:26 BST 2016, Mike Bostock, Mike Bostock, 5, 5, 10, 0, 15
Thu Jun 09 21:07:31 BST 2016, Mike Bostock, Mike Bostock, 3, 1, 4, 0, 26
Thu Jun 09 18:57:17 BST 2016, Mike Bostock, Mike Bostock, 5, 5, 10, 0, 15
Wed Jun 08 23:46:49 BST 2016, Mike Bostock, Mike Bostock, 18, 2, 20, 0, 15
Wed Jun 08 23:43:54 BST 2016, Mike Bostock, Mike Bostock, 2, 2, 4, 0, 15
Wed Jun 08 23:43:19 BST 2016, Mike Bostock, Mike Bostock, 9, 6, 15, 0, 15
Wed Jun 08 21:06:07 BST 2016, Mike Bostock, Mike Bostock, 9, 9, 18, 0, 15
Wed Jun 08 20:14:11 BST 2016, Mike Bostock, Mike Bostock, 1, 1, 2, 0, 15
Wed Jun 08 20:11:25 BST 2016, Mike Bostock, Mike Bostock, 2, 0, 2, 0, 15
Wed Jun 08 20:10:41 BST 2016, Mike Bostock, Mike Bostock, 7, 1, 8, 0, 15
Wed Jun 08 20:04:44 BST 2016, Mike Bostock, Mike Bostock, 4, 4, 8, 0, 15
Wed Jun 08 20:01:57 BST 2016, Mike Bostock, Mike Bostock, 27, 1, 28, 0, 15
Wed Jun 08 19:53:10 BST 2016, Mike Bostock, Mike Bostock, 24, 3, 27, 0, 15
Wed Jun 08 19:36:40 BST 2016, Mike Bostock, Mike Bostock, 1, 1, 2, 0, 15
Wed Jun 08 19:36:22 BST 2016, Mike Bostock, Mike Bostock, 88, 66, 154, 0, 15
Wed Jun 08 19:32:09 BST 2016, Mike Bostock, Mike Bostock, 15, 15, 30, 0, 14
Wed Jun 08 19:29:53 BST 2016, Mike Bostock, Mike Bostock, 2, 2, 4, 0, 15
Wed Jun 08 19:16:46 BST 2016, Mike Bostock, Mike Bostock, 1, 1, 2, 0, 15
Wed Jun 08 19:16:13 BST 2016, Mike Bostock, Mike Bostock, 147, 147, 294, 0, 15
Wed Jun 08 19:15:42 BST 2016, Mike Bostock, Mike Bostock, 5, 5, 10, 0, 15
Wed Jun 08 19:09:21 BST 2016, Mike Bostock, Mike Bostock, 222, 0, 222, 0, 17
Wed Jun 08 18:18:06 BST 2016, Mike Bostock, Mike Bostock, 1, 1, 2, 0, 14
Wed Jun 08 06:00:06 BST 2016, Mike Bostock, Mike Bostock, 1, 1, 2, 0, 14
Wed Jun 08 05:53:27 BST 2016, Mike Bostock, Mike Bostock, 0, 1, 1, 0, 14
Wed Jun 08 05:43:51 BST 2016, Mike Bostock, Mike Bostock, 111, 149, 260, 0, 9
Wed Jun 01 00:07:57 BST 2016, Mike Bostock, Mike Bostock, 27, 26, 53, 0, 18
Thu May 26 17:05:28 BST 2016, Mike Bostock, Mike Bostock, 3, 3, 6, 0, 15
Thu May 26 16:58:26 BST 2016, Mike Bostock, Mike Bostock, 47, 1, 48, 0, 20
Thu May 26 16:51:30 BST 2016, Mike Bostock, Mike Bostock, 3, 1, 4, 0, 28
Thu May 26 06:22:55 BST 2016, Mike Bostock, Mike Bostock, 3, 3, 6, 0, 15
Thu May 26 01:01:19 BST 2016, Mike Bostock, Mike Bostock, 8, 5, 13, 0, 24
Tue May 24 23:55:28 BST 2016, Mike Bostock, Mike Bostock, 57, 25, 82, 0, 9
Sun May 22 06:02:22 BST 2016, Mike Bostock, Mike Bostock, 28, 26, 54, 0, 44
Wed May 18 22:05:28 BST 2016, Mike Bostock, Mike Bostock, 1, 1, 2, 0, 30
Sun May 15 06:05:58 BST 2016, Mike Bostock, Mike Bostock, 1, 1, 2, 0, 14
Fri May 13 19:16:18 BST 2016, Mike Bostock, Mike Bostock, 4, 3, 7, 0, 16
Fri May 13 18:44:24 BST 2016, Mike Bostock, Mike Bostock, 1, 1, 2, 0, 14
Fri May 13 17:20:56 BST 2016, Mike Bostock, Mike Bostock, 1, 1, 2, 0, 14
Fri May 13 17:18:34 BST 2016, Mike Bostock, Mike Bostock, 3, 5, 8, 0, 14
Fri May 13 17:16:17 BST 2016, Mike Bostock, Mike Bostock, 1622, 49840, 51462, 0, 16
Fri May 13 16:50:10 BST 2016, Mike Bostock, Mike Bostock, 1, 1, 2, 0, 16
Thu May 12 21:44:17 BST 2016, Mike Bostock, Mike Bostock, 3, 3, 6, 0, 16
Thu May 12 00:46:45 BST 2016, Mike Bostock, Mike Bostock, 3, 3, 6, 0, 15
Wed May 11 16:51:08 BST 2016, Mike Bostock, Mike Bostock, 7, 2, 9, 0, 31
Wed May 11 16:44:04 BST 2016, Mike Bostock, Mike Bostock, 25, 4, 29, 0, 7
Thu May 05 01:31:01 BST 2016, Mike Bostock, Mike Bostock, 9, 9, 18, 0, 23
Thu May 05 01:29:22 BST 2016, Mike Bostock, Mike Bostock, 1, 1, 2, 0, 6
Thu May 05 01:28:56 BST 2016, Mike Bostock, Mike Bostock, 1, 1, 2, 0, 18
Thu May 05 01:27:30 BST 2016, Mike Bostock, Mike Bostock, 1, 1, 2, 0, 61
Thu May 05 01:23:42 BST 2016, Mike Bostock, Mike Bostock, 1, 1, 2, 0, 17
Tue May 03 19:30:04 BST 2016, Mike Bostock, Mike Bostock, 7, 7, 14, 0, 20
Mon May 02 21:44:35 BST 2016, Mike Bostock, Mike Bostock, 6, 1, 7, 0, 33
Mon May 02 17:27:46 BST 2016, Mike Bostock, Mike Bostock, 5, 5, 10, 0, 7
Fri Apr 29 19:22:34 BST 2016, Mike Bostock, Mike Bostock, 3, 3, 6, 0, 16
Fri Apr 29 18:51:52 BST 2016, Mike Bostock, Mike Bostock, 12, 9, 21, 0, 16
Fri Apr 29 17:12:01 BST 2016, Mike Bostock, Mike Bostock, 3, 3, 6, 0, 16
Fri Apr 29 00:00:57 BST 2016, Mike Bostock, Mike Bostock, 1, 0, 1, 0, 14
Thu Apr 28 23:58:41 BST 2016, Mike Bostock, Mike Bostock, 66, 12, 78, 0, 7
Mon Apr 25 23:27:17 BST 2016, Mike Bostock, Mike Bostock, 1, 1, 2, 0, 14
Mon Apr 25 23:26:55 BST 2016, Mike Bostock, Mike Bostock, 2, 2, 4, 0, 14
Mon Apr 25 23:25:15 BST 2016, Mike Bostock, Mike Bostock, 4, 0, 4, 0, 23
Wed Apr 20 15:19:57 BST 2016, Mike Bostock, Mike Bostock, 123, 3, 126, 0, 71
Wed Apr 20 13:00:33 BST 2016, Minwei Xu, Minwei Xu, 6, 6, 12, 0, 7
Wed Apr 20 12:52:05 BST 2016, Minwei Xu, Minwei Xu, 122, 2, 124, 0, 11
Fri Apr 01 22:39:50 BST 2016, Mike Bostock, Mike Bostock, 81, 2, 83, 0, 17
Thu Mar 31 23:00:02 BST 2016, Lukas Appelhans, Lukas Appelhans, 1, 1, 2, 0, 18
Tue Mar 15 17:20:44 GMT 2016, Mike Bostock, Mike Bostock, 1, 1, 2, 0, 9
Mon Mar 14 20:15:17 GMT 2016, Mike Bostock, Mike Bostock, 1, 2, 3, 0, 12
Mon Mar 14 19:25:49 GMT 2016, Mike Bostock, Mike Bostock, 56, 12, 68, 0, 92
Fri Mar 11 18:54:29 GMT 2016, Mike Bostock, Mike Bostock, 26, 24, 50, 0, 10
Tue Mar 08 04:14:04 GMT 2016, Mike Bostock, Mike Bostock, 3, 3, 6, 0, 16
Sun Mar 06 23:08:16 GMT 2016, Mike Bostock, Mike Bostock, 1, 1, 2, 0, 16
Sun Mar 06 23:06:59 GMT 2016, Mike Bostock, Mike Bostock, 4, 4, 8, 0, 7
Fri Mar 04 17:54:11 GMT 2016, Mike Bostock, Mike Bostock, 2, 2, 4, 0, 30
Thu Mar 03 06:09:48 GMT 2016, Mike Bostock, Mike Bostock, 4, 4, 8, 0, 20
Wed Mar 02 23:12:32 GMT 2016, Mike Bostock, Mike Bostock, 3, 3, 6, 0, 21
Wed Mar 02 17:14:38 GMT 2016, Mike Bostock, Mike Bostock, 1, 0, 1, 0, 25
Wed Mar 02 17:13:41 GMT 2016, Mike Bostock, Mike Bostock, 2, 0, 2, 0, 18
Wed Mar 02 17:11:56 GMT 2016, Mike Bostock, Mike Bostock, 3, 1, 4, 0, 18
Wed Mar 02 00:07:30 GMT 2016, Mike Bostock, Mike Bostock, 1, 1, 2, 0, 7
Tue Mar 01 21:31:01 GMT 2016, Mike Bostock, Mike Bostock, 5, 6, 11, 0, 658
Mon Feb 29 23:55:55 GMT 2016, Mike Bostock, Mike Bostock, 1, 1, 2, 0, 15
Mon Feb 29 19:50:30 GMT 2016, Mike Bostock, Mike Bostock, 1, 1, 2, 0, 31
Sun Feb 28 17:37:40 GMT 2016, Mike Bostock, Mike Bostock, 0, 1, 1, 0, 14
Sun Feb 28 17:37:03 GMT 2016, Mike Bostock, Mike Bostock, 5, 6, 11, 0, 20
Fri Feb 26 23:30:24 GMT 2016, Mike Bostock, Mike Bostock, 3, 3, 6, 0, 21
Fri Feb 26 21:46:19 GMT 2016, Mike Bostock, Mike Bostock, 9, 7, 16, 0, 20
Fri Feb 26 18:18:09 GMT 2016, Mike Bostock, Mike Bostock, 2, 2, 4, 0, 14
Wed Feb 24 05:39:06 GMT 2016, Mike Bostock, Mike Bostock, 4, 4, 8, 0, 30
Wed Feb 24 03:43:07 GMT 2016, Mike Bostock, Mike Bostock, 1, 1, 2, 0, 15
Tue Feb 23 04:53:39 GMT 2016, Mike Bostock, Mike Bostock, 3, 3, 6, 0, 21
Tue Feb 23 04:15:40 GMT 2016, Mike Bostock, Mike Bostock, 4, 4, 8, 0, 26
Mon Feb 22 23:56:43 GMT 2016, Mike Bostock, Mike Bostock, 2, 2, 4, 0, 13
Mon Feb 22 23:56:27 GMT 2016, Mike Bostock, Mike Bostock, 3, 3, 6, 0, 20
Mon Feb 22 17:25:18 GMT 2016, Mike Bostock, Mike Bostock, 1, 1, 2, 0, 16
Mon Feb 22 17:05:50 GMT 2016, Mike Bostock, Mike Bostock, 8, 8, 16, 0, 20
Thu Feb 18 17:50:39 GMT 2016, Mike Bostock, Mike Bostock, 2, 2, 4, 0, 20
Thu Feb 18 01:37:32 GMT 2016, Mike Bostock, Mike Bostock, 18, 15, 33, 0, 378
Thu Feb 18 01:36:45 GMT 2016, Mike Bostock, Mike Bostock, 1, 18, 19, 0, 33
Sat Feb 13 23:07:53 GMT 2016, Mike Bostock, Mike Bostock, 0, 19, 19, 0, 91
Sat Feb 13 23:06:00 GMT 2016, Mike Bostock, Mike Bostock, 1, 29, 30, 0, 27
Fri Feb 12 23:11:22 GMT 2016, Mike Bostock, Mike Bostock, 10, 7, 17, 0, 31
Fri Feb 12 21:51:48 GMT 2016, Mike Bostock, Mike Bostock, 3, 3, 6, 0, 21
Fri Feb 12 01:50:59 GMT 2016, Mike Bostock, Mike Bostock, 1, 1, 2, 0, 12
Thu Feb 11 23:07:56 GMT 2016, Mike Bostock, Mike Bostock, 1, 1, 2, 0, 13
Thu Feb 11 23:02:54 GMT 2016, Mike Bostock, Mike Bostock, 2, 1, 3, 0, 21
Thu Feb 11 21:05:36 GMT 2016, Mike Bostock, Mike Bostock, 2, 0, 2, 0, 22
Thu Feb 11 19:45:18 GMT 2016, Mike Bostock, Mike Bostock, 6, 48, 54, 0, 35
Thu Feb 11 19:43:39 GMT 2016, Mike Bostock, Mike Bostock, 17, 17, 34, 0, 86
Thu Feb 11 18:34:57 GMT 2016, Mike Bostock, Mike Bostock, 1, 1, 2, 0, 16
Thu Feb 11 17:41:02 GMT 2016, Mike Bostock, Mike Bostock, 1, 1, 2, 0, 20
Wed Feb 10 23:08:56 GMT 2016, Mike Bostock, Mike Bostock, 1, 1, 2, 0, 25
Wed Feb 10 22:48:55 GMT 2016, Mike Bostock, Mike Bostock, 1, 1, 2, 0, 10
Wed Feb 10 20:10:50 GMT 2016, Mike Bostock, Mike Bostock, 3, 3, 6, 0, 20
Wed Feb 10 19:17:55 GMT 2016, Mike Bostock, Mike Bostock, 2, 2, 4, 0, 23
Wed Feb 10 18:34:24 GMT 2016, Mike Bostock, Mike Bostock, 3, 1, 4, 0, 15
Wed Feb 10 00:01:18 GMT 2016, Mike Bostock, Mike Bostock, 6, 7, 13, 0, 20
Mon Feb 08 03:47:35 GMT 2016, Mike Bostock, Mike Bostock, 2, 2, 4, 0, 5
Mon Feb 08 03:46:19 GMT 2016, Mike Bostock, Mike Bostock, 3, 3, 6, 0, 28
Fri Feb 05 22:24:13 GMT 2016, Mike Bostock, Mike Bostock, 8, 2, 10, 0, 20
Fri Feb 05 00:28:50 GMT 2016, Mike Bostock, Mike Bostock, 26, 12, 38, 0, 14
Fri Feb 05 00:22:17 GMT 2016, Mike Bostock, Mike Bostock, 2, 2, 4, 0, 20
Thu Feb 04 21:30:54 GMT 2016, Mike Bostock, Mike Bostock, 16, 10, 26, 0, 26
Thu Feb 04 18:04:53 GMT 2016, Mike Bostock, Mike Bostock, 11, 4, 15, 0, 15
Wed Feb 03 22:06:53 GMT 2016, Mike Bostock, Mike Bostock, 1, 1, 2, 0, 16
Wed Feb 03 19:27:41 GMT 2016, Mike Bostock, Mike Bostock, 1, 0, 1, 0, 14
Wed Feb 03 18:51:34 GMT 2016, Mike Bostock, Mike Bostock, 27, 1, 28, 0, 14
Wed Feb 03 18:03:35 GMT 2016, Mike Bostock, Mike Bostock, 2, 2, 4, 0, 13
Wed Feb 03 18:03:07 GMT 2016, Mike Bostock, Mike Bostock, 10, 5, 15, 0, 20
Tue Feb 02 17:40:20 GMT 2016, Mike Bostock, Mike Bostock, 1, 0, 1, 0, 20
Tue Feb 02 17:10:12 GMT 2016, Mike Bostock, Mike Bostock, 6, 5, 11, 0, 16
Mon Feb 01 21:58:34 GMT 2016, Mike Bostock, Mike Bostock, 14, 14, 28, 0, 57
Mon Feb 01 20:30:13 GMT 2016, Mike Bostock, Mike Bostock, 9, 7, 16, 0, 20
Fri Jan 29 18:51:26 GMT 2016, Mike Bostock, Mike Bostock, 1, 1, 2, 0, 19
Fri Jan 29 18:50:58 GMT 2016, Mike Bostock, Mike Bostock, 24, 25, 49, 0, 50
Thu Jan 28 18:53:43 GMT 2016, Mike Bostock, Mike Bostock, 2, 1, 3, 0, 31
Thu Jan 28 18:50:07 GMT 2016, Mike Bostock, Mike Bostock, 2, 2, 4, 0, 9
Thu Jan 28 18:49:59 GMT 2016, Mike Bostock, Mike Bostock, 5, 3, 8, 0, 16
Wed Jan 27 22:51:58 GMT 2016, Mike Bostock, Mike Bostock, 4, 4, 8, 0, 20
Wed Jan 27 17:30:55 GMT 2016, Mike Bostock, Mike Bostock, 43, 12, 55, 0, 351
Sat Jan 23 05:11:53 GMT 2016, Mike Bostock, Mike Bostock, 18, 2, 20, 0, 31
Fri Jan 22 23:56:10 GMT 2016, Mike Bostock, Mike Bostock, 3, 3, 6, 0, 9
Wed Jan 20 18:34:02 GMT 2016, Mike Bostock, Mike Bostock, 3, 3, 6, 0, 20
Wed Jan 20 17:55:52 GMT 2016, Mike Bostock, Mike Bostock, 6, 6, 12, 0, 13
Mon Jan 18 22:57:21 GMT 2016, Mike Bostock, Mike Bostock, 2, 2, 4, 0, 21
Mon Jan 18 22:55:06 GMT 2016, Mike Bostock, Mike Bostock, 1, 1, 2, 0, 12
Mon Jan 18 22:52:42 GMT 2016, Mike Bostock, Mike Bostock, 4, 4, 8, 0, 20
Fri Jan 15 01:33:41 GMT 2016, Mike Bostock, Mike Bostock, 3, 3, 6, 0, 18
Fri Jan 15 01:19:47 GMT 2016, Mike Bostock, Mike Bostock, 4, 4, 8, 0, 31
Fri Jan 15 00:18:50 GMT 2016, Mike Bostock, Mike Bostock, 16, 1, 17, 0, 21
Fri Jan 15 00:06:20 GMT 2016, Mike Bostock, Mike Bostock, 17, 17, 34, 0, 8
Thu Jan 14 01:11:32 GMT 2016, Mike Bostock, Mike Bostock, 3, 0, 3, 0, 18
Wed Jan 13 19:55:16 GMT 2016, Mike Bostock, Mike Bostock, 1, 1, 2, 0, 10
Tue Jan 12 18:39:12 GMT 2016, Mike Bostock, Mike Bostock, 1, 1, 2, 0, 16
Tue Jan 12 18:31:37 GMT 2016, Mike Bostock, Mike Bostock, 4, 2, 6, 0, 15
Mon Jan 11 23:37:16 GMT 2016, Mike Bostock, Mike Bostock, 1, 1, 2, 0, 81
Mon Jan 11 22:27:22 GMT 2016, Fernando Lores, Fernando Lores, 1, 1, 2, 0, 34
Mon Jan 11 19:22:42 GMT 2016, Mike Bostock, Mike Bostock, 1, 0, 1, 0, 21
Mon Jan 11 19:21:37 GMT 2016, Mike Bostock, Mike Bostock, 12, 1, 13, 0, 15
Mon Jan 11 19:16:37 GMT 2016, Mike Bostock, Mike Bostock, 12, 0, 12, 0, 16
Mon Jan 11 19:12:10 GMT 2016, Mike Bostock, Mike Bostock, 20, 0, 20, 0, 15
Sat Jan 09 00:03:00 GMT 2016, Mike Bostock, Mike Bostock, 3, 3, 6, 0, 13
Fri Jan 08 23:28:50 GMT 2016, Mike Bostock, Mike Bostock, 9, 11, 20, 0, 15
Fri Jan 08 22:08:01 GMT 2016, Mike Bostock, Mike Bostock, 32, 1, 33, 0, 12
Fri Jan 08 18:34:48 GMT 2016, Mike Bostock, Mike Bostock, 3, 3, 6, 0, 9
Fri Jan 08 18:33:25 GMT 2016, Mike Bostock, Mike Bostock, 39, 3, 42, 0, 27
Thu Jan 07 23:51:42 GMT 2016, Mike Bostock, Mike Bostock, 193, 191, 384, 0, 10
Thu Jan 07 23:38:12 GMT 2016, Mike Bostock, Mike Bostock, 3, 3, 6, 0, 21
Thu Jan 07 23:37:46 GMT 2016, Mike Bostock, Mike Bostock, 10, 7, 17, 0, 46
Thu Jan 07 23:28:45 GMT 2016, Mike Bostock, Mike Bostock, 34, 34, 68, 0, 16
Thu Jan 07 23:06:39 GMT 2016, Mike Bostock, Mike Bostock, 128, 129, 257, 0, 20
Thu Jan 07 21:10:57 GMT 2016, Mike Bostock, Mike Bostock, 32, 32, 64, 0, 15
Thu Jan 07 20:55:47 GMT 2016, Mike Bostock, Mike Bostock, 13, 13, 26, 0, 17
Thu Jan 07 20:42:41 GMT 2016, Mike Bostock, Mike Bostock, 52, 48, 100, 0, 20
Thu Jan 07 19:58:09 GMT 2016, Mike Bostock, Mike Bostock, 6, 6, 12, 0, 25
Thu Jan 07 19:57:41 GMT 2016, Mike Bostock, Mike Bostock, 29, 12, 41, 0, 25
Thu Jan 07 18:50:09 GMT 2016, Mike Bostock, Mike Bostock, 4, 4, 8, 0, 20
Wed Jan 06 20:50:33 GMT 2016, Mike Bostock, Mike Bostock, 0, 5, 5, 0, 25
Wed Jan 06 20:50:19 GMT 2016, Mike Bostock, Mike Bostock, 40, 35, 75, 0, 25
Wed Jan 06 20:39:00 GMT 2016, Mike Bostock, Mike Bostock, 32, 32, 64, 0, 25
Wed Jan 06 20:32:13 GMT 2016, Mike Bostock, Mike Bostock, 104, 78, 182, 0, 25
Wed Jan 06 19:25:38 GMT 2016, Mike Bostock, Mike Bostock, 32, 32, 64, 0, 25
Wed Jan 06 19:20:44 GMT 2016, Mike Bostock, Mike Bostock, 90, 92, 182, 0, 25
Wed Jan 06 19:01:15 GMT 2016, Mike Bostock, Mike Bostock, 68, 64, 132, 0, 25
Wed Jan 06 18:50:22 GMT 2016, Mike Bostock, Mike Bostock, 1, 1, 2, 0, 9
Wed Jan 06 18:45:58 GMT 2016, Mike Bostock, Mike Bostock, 1, 1, 2, 0, 22
Wed Jan 06 01:27:48 GMT 2016, Mike Bostock, Mike Bostock, 1, 1, 2, 0, 39
Wed Jan 06 01:19:03 GMT 2016, Mike Bostock, Mike Bostock, 42, 8, 50, 0, 25
Wed Jan 06 01:00:11 GMT 2016, Mike Bostock, Mike Bostock, 1, 1, 2, 0, 25
Tue Jan 05 22:53:43 GMT 2016, Mike Bostock, Mike Bostock, 2, 2, 4, 0, 25
Tue Jan 05 22:53:22 GMT 2016, Mike Bostock, Mike Bostock, 9, 9, 18, 0, 25
Tue Jan 05 22:52:12 GMT 2016, Mike Bostock, Mike Bostock, 15, 15, 30, 0, 25
Tue Jan 05 22:41:04 GMT 2016, Mike Bostock, Mike Bostock, 5, 5, 10, 0, 25
Tue Jan 05 22:39:53 GMT 2016, Mike Bostock, Mike Bostock, 12, 10, 22, 0, 25
Tue Jan 05 22:34:54 GMT 2016, Mike Bostock, Mike Bostock, 1, 1, 2, 0, 25
Tue Jan 05 22:34:28 GMT 2016, Mike Bostock, Mike Bostock, 23, 1, 24, 0, 25
Tue Jan 05 22:26:23 GMT 2016, Mike Bostock, Mike Bostock, 4, 1, 5, 0, 25
Tue Jan 05 22:25:18 GMT 2016, Mike Bostock, Mike Bostock, 166, 0, 166, 0, 25
Tue Jan 05 22:06:51 GMT 2016, Mike Bostock, Mike Bostock, 1, 0, 1, 0, 25
Tue Jan 05 22:05:39 GMT 2016, Mike Bostock, Mike Bostock, 17, 17, 34, 0, 25
Tue Jan 05 22:04:44 GMT 2016, Mike Bostock, Mike Bostock, 128, 0, 128, 0, 25
Tue Jan 05 21:50:31 GMT 2016, Mike Bostock, Mike Bostock, 11, 0, 11, 0, 25
Tue Jan 05 21:47:01 GMT 2016, Mike Bostock, Mike Bostock, 14, 14, 28, 0, 25
Tue Jan 05 21:45:33 GMT 2016, Mike Bostock, Mike Bostock, 31, 61, 92, 0, 25
Tue Jan 05 21:42:10 GMT 2016, Mike Bostock, Mike Bostock, 2, 1, 3, 0, 25
Tue Jan 05 21:41:52 GMT 2016, Mike Bostock, Mike Bostock, 75, 0, 75, 0, 25
Tue Jan 05 21:28:50 GMT 2016, Mike Bostock, Mike Bostock, 14, 14, 28, 0, 25
Tue Jan 05 21:28:14 GMT 2016, Mike Bostock, Mike Bostock, 37, 14, 51, 0, 25
Tue Jan 05 21:19:37 GMT 2016, Mike Bostock, Mike Bostock, 53, 0, 53, 0, 25
Tue Jan 05 20:52:22 GMT 2016, Mike Bostock, Mike Bostock, 3, 5, 8, 0, 19
Tue Jan 05 18:29:18 GMT 2016, Mike Bostock, Mike Bostock, 1, 1, 2, 0, 15
Tue Jan 05 18:20:57 GMT 2016, Mike Bostock, Mike Bostock, 35, 0, 35, 0, 25
Tue Jan 05 18:13:41 GMT 2016, Mike Bostock, Mike Bostock, 21, 7, 28, 0, 25
Tue Jan 05 18:08:12 GMT 2016, Mike Bostock, Mike Bostock, 3, 3, 6, 0, 25
Tue Jan 05 17:54:11 GMT 2016, Mike Bostock, Mike Bostock, 3, 3, 6, 0, 20
Tue Jan 05 17:50:32 GMT 2016, Mike Bostock, Mike Bostock, 18, 10, 28, 0, 31
Tue Jan 05 17:12:25 GMT 2016, Mike Bostock, Mike Bostock, 8, 8, 16, 0, 25
Tue Jan 05 17:12:00 GMT 2016, Mike Bostock, Mike Bostock, 10, 10, 20, 0, 25
Tue Jan 05 17:11:28 GMT 2016, Mike Bostock, Mike Bostock, 25, 8, 33, 0, 25
Tue Jan 05 17:05:07 GMT 2016, Mike Bostock, Mike Bostock, 47, 15, 62, 0, 25
Tue Jan 05 16:55:13 GMT 2016, Mike Bostock, Mike Bostock, 78, 1, 79, 0, 25
Wed Sep 09 11:38:50 BST 2015, Stef Walter, Stef Walter, 7, 7, 14, 0, 851
Tue Jan 05 01:21:58 GMT 2016, Mike Bostock, Mike Bostock, 1, 1, 2, 0, 16
Tue Jan 05 01:20:06 GMT 2016, Mike Bostock, Mike Bostock, 2, 2, 4, 0, 17
Tue Jan 05 01:10:00 GMT 2016, Mike Bostock, Mike Bostock, 14, 0, 14, 0, 17
Tue Jan 05 01:06:04 GMT 2016, Mike Bostock, Mike Bostock, 30, 0, 30, 0, 13
Tue Jan 05 01:05:54 GMT 2016, Mike Bostock, Mike Bostock, 7, 0, 7, 0, 10
Tue Jan 05 01:03:16 GMT 2016, Mike Bostock, Mike Bostock, 58, 58, 116, 0, 14
Sat Jan 02 17:31:18 GMT 2016, Mike Bostock, Mike Bostock, 1, 1, 2, 0, 12
Sat Jan 02 17:28:32 GMT 2016, Mike Bostock, Mike Bostock, 137, 1, 138, 0, 49
Sat Jan 02 17:16:22 GMT 2016, Mike Bostock, Mike Bostock, 23, 0, 23, 0, 36
Sat Jan 02 17:12:35 GMT 2016, Mike Bostock, Mike Bostock, 94, 187, 281, 0, 222
Sat Jan 02 16:53:17 GMT 2016, Mike Bostock, Mike Bostock, 1, 1, 2, 0, 22
Sat Jan 02 05:41:20 GMT 2016, Mike Bostock, Mike Bostock, 373, 0, 373, 2, 22
Thu Dec 17 16:54:34 GMT 2015, Mike Bostock, Mike Bostock, 18, 12, 30, 0, 28
Mon Dec 14 19:16:41 GMT 2015, Mike Bostock, Mike Bostock, 52, 17, 69, 0, 21
Mon Dec 14 19:15:13 GMT 2015, Mike Bostock, Mike Bostock, 3, 3, 6, 0, 65
Mon Dec 14 19:13:30 GMT 2015, Mike Bostock, Mike Bostock, 44, 9, 53, 0, 43
Fri Dec 11 08:37:17 GMT 2015, Sherry Zhou, Sherry Zhou, 1, 1, 2, 0, 199
Mon Nov 30 02:39:55 GMT 2015, Mike Bostock, Mike Bostock, 9, 9, 18, 0, 21
Wed Nov 25 17:02:10 GMT 2015, Mike Bostock, Mike Bostock, 3, 3, 6, 0, 58
Mon Nov 16 16:02:22 GMT 2015, Mike Bostock, Mike Bostock, 38, 38, 76, 0, 20
Fri Nov 13 18:25:12 GMT 2015, Mike Bostock, Mike Bostock, 21, 20, 41, 0, 422
Thu Nov 12 14:04:54 GMT 2015, Mike Bostock, Mike Bostock, 3, 3, 6, 0, 32
Wed Nov 11 20:25:24 GMT 2015, Mike Bostock, Mike Bostock, 6, 7, 13, 0, 165
Tue Nov 10 16:34:18 GMT 2015, Mike Bostock, Mike Bostock, 148, 144, 292, 0, 26
Tue Nov 10 15:56:30 GMT 2015, Mike Bostock, Mike Bostock, 143, 139, 282, 0, 151
Tue Nov 10 03:57:48 GMT 2015, Mike Bostock, Mike Bostock, 1080, 900, 1980, 0, 20
Mon Nov 09 16:49:45 GMT 2015, Mike Bostock, Mike Bostock, 14, 16, 30, 0, 216
Sun Nov 08 22:24:12 GMT 2015, Mike Bostock, Mike Bostock, 21, 5, 26, 0, 31
Sun Nov 08 22:18:41 GMT 2015, Mike Bostock, Mike Bostock, 17, 3, 20, 0, 130
Mon Nov 02 18:45:15 GMT 2015, Mike Bostock, Mike Bostock, 646, 646, 1292, 0, 55
Mon Nov 02 18:23:28 GMT 2015, Mike Bostock, Mike Bostock, 5, 3, 8, 0, 72
Fri Oct 30 20:46:41 GMT 2015, Mike Bostock, Mike Bostock, 1, 1, 2, 0, 24
Mon Oct 26 04:08:38 GMT 2015, Mike Bostock, Mike Bostock, 8, 14, 22, 0, 43
Mon Oct 26 03:46:20 GMT 2015, Mike Bostock, Mike Bostock, 3, 3, 6, 0, 139
Mon Oct 26 03:21:48 GMT 2015, Mike Bostock, Mike Bostock, 12, 4, 16, 0, 33
Mon Oct 26 03:18:56 GMT 2015, Mike Bostock, Mike Bostock, 2, 1, 3, 0, 106
Mon Oct 26 03:10:53 GMT 2015, Mike Bostock, Mike Bostock, 136, 0, 136, 0, 75
Sun Oct 25 22:29:19 GMT 2015, Mike Bostock, Mike Bostock, 26, 11, 37, 0, 46
Sun Oct 25 22:11:46 GMT 2015, Mike Bostock, Mike Bostock, 23, 16, 39, 0, 94
Sun Oct 25 22:04:32 GMT 2015, Mike Bostock, Mike Bostock, 118, 111, 229, 0, 103
Sun Oct 25 21:42:51 GMT 2015, Mike Bostock, Mike Bostock, 205, 163, 368, 0, 256
Sat Oct 24 22:23:36 BST 2015, ppeterka, ppeterka, 136, 0, 136, 0, 22
Sat Oct 24 16:57:05 BST 2015, Mike Bostock, Mike Bostock, 51, 13, 64, 0, 34
Fri Oct 23 21:49:49 BST 2015, Mike Bostock, Mike Bostock, 6, 3, 9, 0, 42
Fri Oct 23 19:19:57 BST 2015, Mike Bostock, Mike Bostock, 44, 34, 78, 0, 44
Fri Oct 23 05:33:50 BST 2015, Mike Bostock, Mike Bostock, 78, 61, 139, 0, 40
Thu Oct 22 22:54:24 BST 2015, Mike Bostock, Mike Bostock, 27, 18, 45, 0, 44
Thu Oct 22 22:07:50 BST 2015, Mike Bostock, Mike Bostock, 3, 3, 6, 0, 8
Thu Oct 22 22:05:02 BST 2015, Mike Bostock, Mike Bostock, 3, 3, 6, 0, 60
Thu Oct 22 21:35:16 BST 2015, Mike Bostock, Mike Bostock, 8, 18, 26, 0, 72
Thu Oct 22 21:31:51 BST 2015, Mike Bostock, Mike Bostock, 6, 1, 7, 0, 46
Thu Oct 22 21:27:56 BST 2015, Mike Bostock, Mike Bostock, 5, 1, 6, 0, 75
Wed Oct 21 19:51:31 BST 2015, Mike Bostock, Mike Bostock, 18, 18, 36, 0, 24
Wed Oct 21 19:49:42 BST 2015, Mike Bostock, Mike Bostock, 16, 0, 16, 0, 17
Wed Oct 21 19:44:27 BST 2015, Mike Bostock, Mike Bostock, 1, 1, 2, 0, 1
Wed Oct 21 19:44:01 BST 2015, Mike Bostock, Mike Bostock, 16, 0, 16, 0, 70
Wed Oct 21 18:51:49 BST 2015, Mike Bostock, Mike Bostock, 1, 1, 2, 0, 24
Wed Oct 21 18:51:23 BST 2015, Mike Bostock, Mike Bostock, 16, 0, 16, 0, 79
Wed Oct 21 18:09:30 BST 2015, Mike Bostock, Mike Bostock, 16, 0, 16, 0, 79
Wed Oct 21 17:23:46 BST 2015, Mike Bostock, Mike Bostock, 42, 6, 48, 0, 416
Fri Sep 18 15:16:34 BST 2015, Yuichi Yazaki, Yuichi Yazaki, 16, 0, 16, 0, 22
Fri Aug 21 18:11:24 BST 2015, leitzler, leitzler, 16, 0, 16, 0, 66
Sat Jul 04 04:05:41 BST 2015, Mike Bostock, Mike Bostock, 2, 3, 5, 0, 8
Sat Jul 04 04:03:11 BST 2015, Mike Bostock, Mike Bostock, 31, 56, 87, 0, 20
Sat Jul 04 03:59:48 BST 2015, Mike Bostock, Mike Bostock, 2, 3, 5, 0, 57
Sat Jul 04 03:59:03 BST 2015, Mike Bostock, Mike Bostock, 0, 32, 32, 0, 26
Sat Jul 04 03:58:25 BST 2015, Mike Bostock, Mike Bostock, 0, 1, 1, 0, 67
Sat Jul 04 03:56:49 BST 2015, Mike Bostock, Mike Bostock, 19, 8, 27, 0, 70
Tue May 19 15:40:12 BST 2015, Mike Bostock, Mike Bostock, 1, 6, 7, 0, 70
Tue May 19 11:23:15 BST 2015, Gilad Peleg, Gilad Peleg, 1, 6, 7, 0, 140
Wed May 13 04:09:35 BST 2015, Chris Rebert, Chris Rebert, 0, 1, 1, 1, 133
Wed May 06 18:48:09 BST 2015, patriciaborges, patriciaborges, 2, 1, 3, 0, 39
Tue Apr 07 06:25:49 BST 2015, Jaemin Jo, Jaemin Jo, 1, 1, 2, 0, 13
Tue Apr 07 06:19:54 BST 2015, Jaemin Jo, Jaemin Jo, 16, 0, 16, 0, 18
Mon Apr 06 23:28:16 BST 2015, Mike Bostock, Mike Bostock, 1, 1, 2, 0, 91
Mon Apr 06 22:49:16 BST 2015, Jonathan Huang, Jonathan Huang, 1, 1, 2, 0, 16
Sat Apr 04 10:58:28 BST 2015, Jason Davies, Jason Davies, 4, 4, 8, 0, 370
Wed Apr 01 08:58:24 BST 2015, Jason Davies, Jason Davies, 19, 8, 27, 0, 66
Tue Mar 31 21:42:15 BST 2015, Nathan Vander Wilt, Nathan Vander Wilt, 7, 3, 10, 0, 299
Tue Mar 24 13:54:11 GMT 2015, Jason Davies, Jason Davies, 3, 5, 8, 0, 527
Fri Feb 13 06:30:56 GMT 2015, Jonathan Huang, Jonathan Huang, 1, 1, 2, 0, 166
Thu Feb 12 23:17:34 GMT 2015, Jonathan Huang, Jonathan Huang, 1, 1, 2, 0, 497
Thu Feb 12 23:10:10 GMT 2015, Jonathan Huang, Jonathan Huang, 1, 1, 2, 0, 191
Thu Feb 12 03:10:24 GMT 2015, Mike Bostock, Mike Bostock, 1, 1, 2, 0, 80
Wed Feb 11 07:00:17 GMT 2015, William Wung, William Wung, 1, 1, 2, 0, 337
Tue Feb 10 16:41:56 GMT 2015, Mike Bostock, Mike Bostock, 1, 1, 2, 0, 30
Tue Feb 10 16:36:27 GMT 2015, Mike Bostock, Mike Bostock, 5, 1, 6, 0, 19
Tue Feb 10 16:33:30 GMT 2015, Mike Bostock, Mike Bostock, 95, 14, 109, 0, 226
Sun Feb 08 19:29:34 GMT 2015, Mike Bostock, Mike Bostock, 1, 1, 2, 0, 22
Sun Feb 08 19:29:21 GMT 2015, Mike Bostock, Mike Bostock, 1, 1, 2, 0, 32
Sun Feb 08 18:27:47 GMT 2015, Mike Bostock, Mike Bostock, 5, 0, 5, 0, 42
Sun Feb 08 18:20:33 GMT 2015, Mike Bostock, Mike Bostock, 1, 1, 2, 0, 41
Sun Feb 08 17:20:49 GMT 2015, Mike Bostock, Mike Bostock, 40, 1, 41, 0, 74
Sun Feb 08 02:48:24 GMT 2015, Mike Bostock, Mike Bostock, 5, 15, 20, 1, 99
Sat Feb 07 20:31:21 GMT 2015, Mike Bostock, Mike Bostock, 327, 223, 550, 0, 20
Sat Feb 07 19:58:56 GMT 2015, Mike Bostock, Mike Bostock, 6, 6, 12, 0, 87
Sat Feb 07 18:56:17 GMT 2015, Mike Bostock, Mike Bostock, 0, 3, 3, 0, 102
Sat Feb 07 16:46:43 GMT 2015, Mike Bostock, Mike Bostock, 16, 0, 16, 0, 68
Sat Feb 07 16:43:36 GMT 2015, Mike Bostock, Mike Bostock, 16, 0, 16, 0, 76
Sat Feb 07 16:41:44 GMT 2015, Mike Bostock, Mike Bostock, 23, 8, 31, 0, 65
Sat Feb 07 16:40:09 GMT 2015, Mike Bostock, Mike Bostock, 12, 4, 16, 0, 86
Sat Feb 07 16:34:36 GMT 2015, Mike Bostock, Mike Bostock, 1, 1, 2, 0, 74
Sat Feb 07 16:33:21 GMT 2015, Mike Bostock, Mike Bostock, 5, 5, 10, 0, 41
Sat Feb 07 16:29:07 GMT 2015, Mike Bostock, Mike Bostock, 20, 4, 24, 0, 84
Sat Feb 07 16:21:51 GMT 2015, Mike Bostock, Mike Bostock, 3, 0, 3, 0, 23
Sat Feb 07 16:20:24 GMT 2015, Mike Bostock, Mike Bostock, 3, 1, 4, 0, 63
Sat Feb 07 16:13:36 GMT 2015, Mike Bostock, Mike Bostock, 1, 1, 2, 0, 106
Sat Feb 07 16:08:10 GMT 2015, Mike Bostock, Mike Bostock, 3, 3, 6, 0, 33
Sat Feb 07 13:47:33 GMT 2015, Jason Davies, Jason Davies, 7, 7, 14, 0, 227
Sat Feb 07 06:30:25 GMT 2015, Mike Bostock, Mike Bostock, 261, 201, 462, 0, 629
Fri Feb 06 00:17:20 GMT 2015, Wil Gieseler, Wil Gieseler, 8, 6, 14, 0, 8
Fri Feb 06 00:16:33 GMT 2015, Wil Gieseler, Wil Gieseler, 15, 1, 16, 0, 33
Thu Feb 05 16:34:11 GMT 2015, Alex Simoes, Alex Simoes, 1, 1, 2, 0, 23
Sat Jan 31 14:47:32 GMT 2015, Luca Mussi, Luca Mussi, 13, 0, 13, 0, 16
Sat Jan 31 14:16:52 GMT 2015, Luca Mussi, Luca Mussi, 1, 3, 4, 0, 7
Sat Jan 31 14:15:45 GMT 2015, Luca Mussi, Luca Mussi, 1, 1, 2, 0, 21
Sat Jan 31 13:42:16 GMT 2015, Luca Mussi, Luca Mussi, 28, 47, 75, 0, 62
Fri Jan 30 11:15:19 GMT 2015, Dan Dascalescu, Dan Dascalescu, 1430, 471, 1901, 0, 70
Wed Jan 28 12:18:38 GMT 2015, Vlad-Ștefan Harbuz, Vlad-Ștefan Harbuz, 7, 5, 12, 0, 37
Thu Jan 15 10:10:52 GMT 2015, Arjen van Oostrum, Arjen van Oostrum, 4, 4, 8, 0, 53
Wed Jan 14 08:12:48 GMT 2015, Arjen van Oostrum, Arjen van Oostrum, 16, 0, 16, 0, 16
Tue Jan 13 00:17:08 GMT 2015, Jason Davies, Jason Davies, 3, 1, 4, 0, 40
Wed Dec 31 00:05:29 GMT 2014, Thomas Preusse, Thomas Preusse, 12, 4, 16, 0, 32
Tue Dec 30 17:02:12 GMT 2014, Mike Bostock, Mike Bostock, 53, 22, 75, 0, 226
Mon Dec 22 22:17:18 GMT 2014, Mike Bostock, Mike Bostock, 27, 12, 39, 0, 320
Fri Dec 19 06:25:49 GMT 2014, Dan Dascalescu, Dan Dascalescu, 3, 4, 7, 0, 37
Thu Dec 11 10:29:38 GMT 2014, mauromelis, mauromelis, 16, 0, 16, 0, 18
Tue Dec 09 23:17:44 GMT 2014, Chris Rebert, Chris Rebert, 0, 3, 3, 0, 55
Tue Dec 09 18:11:40 GMT 2014, Mike Bostock, Mike Bostock, 38, 11, 49, 0, 20
Tue Dec 09 17:39:27 GMT 2014, Mike Bostock, Mike Bostock, 8, 8, 16, 0, 24
Mon Dec 08 19:55:47 GMT 2014, Mike Bostock, Mike Bostock, 32, 5, 37, 0, 48
Mon Dec 08 18:50:38 GMT 2014, Mike Bostock, Mike Bostock, 189, 104, 293, 0, 20
Mon Dec 08 18:29:02 GMT 2014, Mike Bostock, Mike Bostock, 179, 94, 273, 0, 980
Mon Dec 08 17:44:25 GMT 2014, Mike Bostock, Mike Bostock, 6, 6, 12, 0, 45
Sat Dec 06 22:28:55 GMT 2014, Mike Bostock, Mike Bostock, 1248, 430, 1678, 0, 18
Sat Dec 06 21:54:07 GMT 2014, Mike Bostock, Mike Bostock, 22, 8, 30, 0, 30
Sat Dec 06 21:47:51 GMT 2014, Mike Bostock, Mike Bostock, 14, 8, 22, 0, 66
Sat Dec 06 21:31:35 GMT 2014, Mike Bostock, Mike Bostock, 26, 19, 45, 0, 38
Sat Dec 06 21:26:08 GMT 2014, Mike Bostock, Mike Bostock, 5, 0, 5, 0, 41
Sat Dec 06 21:21:54 GMT 2014, Mike Bostock, Mike Bostock, 2, 6, 8, 0, 30
Sat Dec 06 21:21:02 GMT 2014, Mike Bostock, Mike Bostock, 2, 6, 8, 0, 158
Mon Dec 01 19:42:10 GMT 2014, Mike Bostock, Mike Bostock, 31, 10, 41, 0, 43
Sun Nov 30 10:05:18 GMT 2014, Dan Dascalescu, Dan Dascalescu, 8, 69, 77, 0, 34
Sat Nov 29 22:39:59 GMT 2014, Dan Dascalescu, Dan Dascalescu, 30, 81, 111, 0, 41
Tue Nov 25 07:41:28 GMT 2014, Dan Dascalescu, Dan Dascalescu, 161, 0, 161, 0, 28
Tue Nov 25 04:08:23 GMT 2014, Max Goldstein, Max Goldstein, 5, 4, 9, 0, 25
Thu Nov 20 17:58:14 GMT 2014, Mike Bostock, Mike Bostock, 5, 10, 15, 0, 40
Thu Nov 20 05:48:07 GMT 2014, Mike Bostock, Mike Bostock, 7, 7, 14, 0, 17
Thu Nov 20 05:39:58 GMT 2014, Mike Bostock, Mike Bostock, 4, 4, 8, 0, 24
Thu Nov 20 05:38:29 GMT 2014, Mike Bostock, Mike Bostock, 7, 5, 12, 0, 36
Thu Nov 20 03:30:12 GMT 2014, Mike Bostock, Mike Bostock, 3, 3, 6, 0, 126
Wed Nov 19 23:19:45 GMT 2014, Mike Bostock, Mike Bostock, 26, 35, 61, 0, 29
Wed Nov 19 18:31:48 GMT 2014, Mike Bostock, Mike Bostock, 18, 19, 37, 0, 38
Wed Nov 19 18:25:27 GMT 2014, Mike Bostock, Mike Bostock, 15, 14, 29, 0, 42
Wed Nov 19 17:57:21 GMT 2014, Mike Bostock, Mike Bostock, 38, 38, 76, 0, 181
Wed Nov 19 17:41:00 GMT 2014, Mike Bostock, Mike Bostock, 58, 45, 103, 0, 8
Wed Nov 19 08:04:32 GMT 2014, Mike Bostock, Mike Bostock, 7, 15, 22, 0, 3
Wed Nov 19 07:50:51 GMT 2014, Mike Bostock, Mike Bostock, 71, 26, 97, 0, 9
Wed Nov 19 05:32:10 GMT 2014, Mike Bostock, Mike Bostock, 5, 9, 14, 0, 19
Wed Nov 19 05:28:43 GMT 2014, Mike Bostock, Mike Bostock, 102, 99, 201, 0, 15
Wed Nov 19 03:54:55 GMT 2014, Mike Bostock, Mike Bostock, 19, 11, 30, 0, 15
Tue Nov 18 07:02:44 GMT 2014, Mike Bostock, Mike Bostock, 186, 94, 280, 0, 11
Tue Nov 18 05:48:23 GMT 2014, Mike Bostock, Mike Bostock, 60, 37, 97, 0, 590
Mon Nov 17 23:43:14 GMT 2014, Mike Bostock, Mike Bostock, 1, 1, 2, 0, 8
Mon Nov 17 23:21:57 GMT 2014, Mike Bostock, Mike Bostock, 13, 12, 25, 0, 39
Mon Nov 17 21:59:30 GMT 2014, Mike Bostock, Mike Bostock, 34, 81, 115, 0, 45
Mon Nov 17 21:53:33 GMT 2014, Mike Bostock, Mike Bostock, 54, 17, 71, 0, 11
Mon Nov 17 19:30:05 GMT 2014, Mike Bostock, Mike Bostock, 11, 11, 22, 0, 23
Mon Nov 17 19:01:59 GMT 2014, Mike Bostock, Mike Bostock, 28, 19, 47, 0, 27
Mon Nov 17 17:03:43 GMT 2014, Mike Bostock, Mike Bostock, 15, 3, 18, 0, 31
Mon Nov 17 07:49:24 GMT 2014, Mike Bostock, Mike Bostock, 3, 3, 6, 0, 136
Mon Nov 17 07:47:12 GMT 2014, Mike Bostock, Mike Bostock, 12, 1, 13, 0, 34
Mon Nov 17 07:40:44 GMT 2014, Mike Bostock, Mike Bostock, 48, 33, 81, 0, 138
Mon Nov 17 06:09:18 GMT 2014, Mike Bostock, Mike Bostock, 19, 24, 43, 0, 9
Mon Nov 17 05:58:29 GMT 2014, Mike Bostock, Mike Bostock, 76, 69, 145, 0, 14
Mon Nov 17 04:46:02 GMT 2014, Mike Bostock, Mike Bostock, 23, 9, 32, 0, 30
Mon Nov 17 04:39:47 GMT 2014, Mike Bostock, Mike Bostock, 17, 18, 35, 0, 30
Mon Nov 17 02:58:58 GMT 2014, Mike Bostock, Mike Bostock, 11, 7, 18, 0, 19
Sun Nov 16 23:28:29 GMT 2014, Mike Bostock, Mike Bostock, 80, 27, 107, 0, 241
Sun Nov 16 06:50:27 GMT 2014, Mike Bostock, Mike Bostock, 78, 95, 173, 0, 334
Sat Nov 15 22:35:29 GMT 2014, Mike Bostock, Mike Bostock, 59, 9, 68, 0, 74
Sat Nov 15 22:19:49 GMT 2014, Mike Bostock, Mike Bostock, 46, 40, 86, 0, 27
Sat Nov 15 16:57:34 GMT 2014, Mike Bostock, Mike Bostock, 23, 20, 43, 0, 191
Sat Nov 15 01:59:23 GMT 2014, Mike Bostock, Mike Bostock, 35, 55, 90, 0, 25
Fri Nov 14 21:31:28 GMT 2014, Mike Bostock, Mike Bostock, 157, 1, 158, 0, 65
Fri Nov 14 21:12:01 GMT 2014, Mike Bostock, Mike Bostock, 10, 10, 20, 0, 85
Fri Nov 14 21:04:12 GMT 2014, Mike Bostock, Mike Bostock, 117, 16, 133, 0, 60
Fri Nov 14 20:55:22 GMT 2014, Mike Bostock, Mike Bostock, 6, 6, 12, 0, 27
Fri Nov 14 20:54:48 GMT 2014, Mike Bostock, Mike Bostock, 108, 13, 121, 0, 65
Fri Nov 14 20:54:25 GMT 2014, Mike Bostock, Mike Bostock, 26, 24, 50, 0, 98
Fri Nov 14 20:53:01 GMT 2014, Mike Bostock, Mike Bostock, 32, 0, 32, 0, 65
Fri Nov 14 20:52:33 GMT 2014, Mike Bostock, Mike Bostock, 16, 0, 16, 0, 38
Fri Nov 14 20:52:23 GMT 2014, Mike Bostock, Mike Bostock, 16, 0, 16, 0, 66
Fri Nov 14 20:52:08 GMT 2014, Mike Bostock, Mike Bostock, 15, 14, 29, 0, 54
Fri Nov 14 20:51:42 GMT 2014, Mike Bostock, Mike Bostock, 15, 14, 29, 0, 98
Fri Nov 14 20:51:06 GMT 2014, Mike Bostock, Mike Bostock, 126, 107, 233, 0, 114
Fri Nov 14 20:50:10 GMT 2014, Mike Bostock, Mike Bostock, 35, 17, 52, 0, 56
Fri Nov 14 20:49:41 GMT 2014, Mike Bostock, Mike Bostock, 16, 16, 32, 0, 63
Fri Nov 14 20:45:27 GMT 2014, Mike Bostock, Mike Bostock, 37, 10, 47, 0, 59
Fri Nov 14 20:44:56 GMT 2014, Mike Bostock, Mike Bostock, 3, 3, 6, 0, 52
Fri Nov 14 20:44:35 GMT 2014, Mike Bostock, Mike Bostock, 4, 4, 8, 0, 62
Fri Nov 14 20:44:07 GMT 2014, Mike Bostock, Mike Bostock, 14, 8, 22, 0, 60
Fri Nov 14 18:53:32 GMT 2014, Mike Bostock, Mike Bostock, 14, 8, 22, 0, 757
Thu Nov 13 17:30:21 GMT 2014, Jason Davies, Jason Davies, 2, 2, 4, 0, 29
Thu Nov 13 10:13:24 GMT 2014, Jason Davies, Jason Davies, 4, 4, 8, 0, 473
Mon Nov 03 22:06:33 GMT 2014, Jason Davies, Jason Davies, 3, 3, 6, 0, 99
Sun Oct 26 08:52:54 GMT 2014, Alon Levy, Alon Levy, 7, 7, 14, 0, 225
Fri Oct 24 19:25:41 BST 2014, Mike Bostock, Mike Bostock, 37, 10, 47, 0, 668
Thu Oct 23 23:08:17 BST 2014, Mike Bostock, Mike Bostock, 3, 3, 6, 0, 182
Sat Oct 18 11:36:03 BST 2014, Jason Davies, Jason Davies, 35, 17, 52, 0, 514
Thu Oct 23 18:25:17 BST 2014, Mike Bostock, Mike Bostock, 2, 2, 4, 0, 104
Thu Oct 23 18:05:38 BST 2014, Robert Buchholz, Robert Buchholz, 2, 2, 4, 0, 165
Thu Oct 23 17:56:09 BST 2014, Mike Bostock, Mike Bostock, 126, 107, 233, 0, 23
Wed Oct 22 23:55:54 BST 2014, Dorota, Dorota, 1, 1, 2, 0, 139
Wed Oct 22 18:43:21 BST 2014, Mike Bostock, Mike Bostock, 946, 714, 1660, 0, 42
Tue Oct 21 14:21:25 BST 2014, Phil Elson, Phil Elson, 14, 14, 28, 0, 8
Tue Oct 21 13:43:31 BST 2014, Phil Elson, Phil Elson, 1, 0, 1, 0, 42
Fri Oct 17 13:01:43 BST 2014, Jason Davies, Jason Davies, 6, 6, 12, 0, 13
Fri Oct 17 07:22:56 BST 2014, Mike Bostock, Mike Bostock, 1, 5, 6, 0, 19
Fri Oct 17 07:20:36 BST 2014, Mike Bostock, Mike Bostock, 17, 17, 34, 0, 26
Fri Oct 17 07:15:57 BST 2014, Mike Bostock, Mike Bostock, 8, 10, 18, 0, 29
Fri Oct 17 07:04:51 BST 2014, Mike Bostock, Mike Bostock, 19, 17, 36, 0, 38
Fri Oct 17 07:04:11 BST 2014, Mike Bostock, Mike Bostock, 72, 24, 96, 0, 37
Fri Oct 17 07:03:41 BST 2014, Mike Bostock, Mike Bostock, 28, 25, 53, 0, 48
Fri Oct 17 07:02:59 BST 2014, Mike Bostock, Mike Bostock, 6, 4, 10, 0, 38
Fri Oct 17 07:02:25 BST 2014, Mike Bostock, Mike Bostock, 31, 3, 34, 0, 50
Fri Oct 17 07:01:52 BST 2014, Mike Bostock, Mike Bostock, 26, 16, 42, 0, 40
Fri Oct 17 07:01:34 BST 2014, Mike Bostock, Mike Bostock, 262, 260, 522, 0, 38
Fri Oct 17 07:00:51 BST 2014, Mike Bostock, Mike Bostock, 100, 25, 125, 0, 42
Fri Oct 17 07:00:20 BST 2014, Mike Bostock, Mike Bostock, 38, 99, 137, 0, 40
Fri Oct 17 06:24:52 BST 2014, Mike Bostock, Mike Bostock, 6, 4, 10, 0, 47
Fri Oct 17 06:16:51 BST 2014, Mike Bostock, Mike Bostock, 93, 158, 251, 0, 175
Fri Oct 17 06:07:48 BST 2014, Mike Bostock, Mike Bostock, 36, 133, 169, 0, 190
Fri Oct 17 05:59:46 BST 2014, Mike Bostock, Mike Bostock, 15, 18, 33, 0, 93
Fri Oct 17 05:40:06 BST 2014, Mike Bostock, Mike Bostock, 38, 99, 137, 0, 27
Fri Oct 17 05:10:41 BST 2014, Mike Bostock, Mike Bostock, 58, 20, 78, 0, 102
Fri Oct 17 00:14:57 BST 2014, Jason Davies, Jason Davies, 15, 5, 20, 0, 238
Thu Oct 16 09:40:35 BST 2014, Jason Davies, Jason Davies, 29, 8, 37, 0, 55
Thu Oct 16 09:16:02 BST 2014, Jason Davies, Jason Davies, 11, 5, 16, 0, 53
Wed Oct 15 18:20:56 BST 2014, Mike Bostock, Mike Bostock, 219, 75, 294, 0, 51
Wed Oct 15 17:53:45 BST 2014, Mike Bostock, Mike Bostock, 58, 101, 159, 0, 33
Tue Oct 14 18:20:43 BST 2014, Mike Bostock, Mike Bostock, 12, 15, 27, 0, 18
Tue Oct 14 18:15:38 BST 2014, Mike Bostock, Mike Bostock, 33, 0, 33, 0, 28
Tue Oct 14 18:15:10 BST 2014, Mike Bostock, Mike Bostock, 5, 5, 10, 0, 22
Tue Oct 14 18:09:07 BST 2014, Mike Bostock, Mike Bostock, 135, 54, 189, 0, 470
Tue Oct 14 02:17:59 BST 2014, John Firebaugh, John Firebaugh, 51, 19, 70, 0, 363
Mon Oct 13 22:32:08 BST 2014, Mike Bostock, Mike Bostock, 262, 260, 522, 0, 265
Mon Oct 13 21:07:14 BST 2014, Dorota, Dorota, 16, 0, 16, 0, 24
Fri Oct 10 19:09:27 BST 2014, Jason Davies, Jason Davies, 5, 5, 10, 0, 25
Fri Oct 10 18:59:49 BST 2014, Mike Bostock, Mike Bostock, 13, 19, 32, 0, 11
Fri Oct 10 18:31:25 BST 2014, Jason Davies, Jason Davies, 3, 0, 3, 0, 37
Tue Jul 29 20:32:58 BST 2014, Dave Landry, Mike Bostock, 16, 0, 16, 0, 21
Tue Jul 29 19:05:08 BST 2014, Dave Landry, Mike Bostock, 16, 0, 16, 0, 25
Fri Oct 10 18:05:20 BST 2014, Mike Bostock, Mike Bostock, 1, 1, 2, 0, 19
Fri Oct 10 18:04:29 BST 2014, Mike Bostock, Mike Bostock, 16, 0, 16, 0, 68
Fri Oct 10 18:04:25 BST 2014, Mike Bostock, Mike Bostock, 1, 1, 2, 0, 19
Fri Oct 10 18:02:45 BST 2014, Mike Bostock, Mike Bostock, 16, 0, 16, 0, 68
Fri Oct 10 17:53:19 BST 2014, Jason Davies, Jason Davies, 19, 13, 32, 0, 141
Fri Oct 10 17:46:55 BST 2014, Mike Bostock, Mike Bostock, 26, 9, 35, 0, 46
Fri Oct 10 17:35:51 BST 2014, Mike Bostock, Mike Bostock, 0, 7, 7, 0, 91
Fri Oct 10 17:21:20 BST 2014, Mike Bostock, Mike Bostock, 31, 3, 34, 0, 40
Fri Oct 10 11:01:40 BST 2014, Jason Davies, Jason Davies, 6, 4, 10, 0, 56
Fri Oct 10 10:09:57 BST 2014, Jason Davies, Jason Davies, 26, 26, 52, 0, 1466
Thu Aug 28 12:16:06 BST 2014, Jason Davies, Jason Davies, 71, 23, 94, 0, 381
Thu Oct 09 20:16:04 BST 2014, Mike Bostock, Mike Bostock, 8, 8, 16, 0, 21
Thu Oct 09 17:13:04 BST 2014, Mike Bostock, Mike Bostock, 7, 5, 12, 0, 16
Thu Oct 09 17:10:51 BST 2014, Mike Bostock, Mike Bostock, 19, 32, 51, 0, 8
Thu Aug 07 14:44:56 BST 2014, Jason Davies, Jason Davies, 22, 9, 31, 0, 521
Fri Oct 03 21:05:59 BST 2014, Jason Davies, Jason Davies, 10, 5, 15, 0, 532
Wed Oct 08 16:45:31 BST 2014, Mike Bostock, Mike Bostock, 3, 0, 3, 0, 18
Wed Oct 08 16:09:42 BST 2014, Mike Bostock, Mike Bostock, 6, 6, 12, 0, 13
Wed Oct 08 16:04:33 BST 2014, Mike Bostock, Mike Bostock, 8, 3, 11, 0, 48
Wed Oct 08 16:03:32 BST 2014, Mike Bostock, Mike Bostock, 5, 4, 9, 0, 24
Wed Oct 08 15:58:29 BST 2014, Mike Bostock, Mike Bostock, 49, 58, 107, 0, 61
Wed Oct 08 15:49:11 BST 2014, Mike Bostock, Mike Bostock, 80, 80, 160, 0, 55
Wed Oct 08 15:47:58 BST 2014, Mike Bostock, Mike Bostock, 18, 7, 25, 0, 64
Wed Oct 08 15:46:42 BST 2014, Mike Bostock, Mike Bostock, 7, 5, 12, 0, 68
Wed Oct 08 15:45:27 BST 2014, Mike Bostock, Mike Bostock, 8, 4, 12, 0, 60
Fri Oct 03 22:05:25 BST 2014, Jason Davies, Jason Davies, 8, 4, 12, 0, 32
Thu Oct 02 12:28:44 BST 2014, Yves Le Maout, Yves Le Maout, 11, 11, 22, 0, 94
Tue Sep 30 00:01:41 BST 2014, Jason Davies, Jason Davies, 7, 5, 12, 0, 288
Sun Sep 28 13:49:31 BST 2014, Thomas Fankhauser, Thomas Fankhauser, 28, 28, 56, 0, 37
Sat Sep 27 12:23:03 BST 2014, Thomas Fankhauser, Thomas Fankhauser, 21, 21, 42, 0, 85
Sat Sep 27 12:17:03 BST 2014, Thomas Fankhauser, Thomas Fankhauser, 44, 35, 79, 0, 88
Wed Sep 10 12:00:54 BST 2014, Jason Davies, Jason Davies, 7, 3, 10, 0, 59
Thu Aug 28 17:21:18 BST 2014, Philippe Serhal, Philippe Serhal, 16, 0, 16, 0, 106
Thu Aug 28 16:18:56 BST 2014, Philippe Serhal, Philippe Serhal, 16, 0, 16, 0, 107
Mon Aug 25 16:55:58 BST 2014, Martin Häcker, Martin Häcker, 1, 1, 2, 0, 31
Fri Aug 15 22:34:21 BST 2014, Mike Bostock, Mike Bostock, 12, 6, 18, 0, 459
Fri Aug 15 22:32:48 BST 2014, Mike Bostock, Mike Bostock, 15, 19, 34, 0, 197
Wed Aug 13 06:50:36 BST 2014, Martin Häcker, Martin Häcker, 16, 0, 16, 0, 17
Tue Aug 12 10:47:18 BST 2014, Martin Häcker, Martin Häcker, 16, 0, 16, 0, 17
Wed Aug 06 17:32:49 BST 2014, Jason Davies, Jason Davies, 80, 80, 160, 0, 330
Fri Jul 18 17:26:37 BST 2014, Jason Davies, Jason Davies, 49, 58, 107, 0, 18
Tue Aug 05 19:17:34 BST 2014, Mike Bostock, Mike Bostock, 1, 0, 1, 1, 19
Tue Jul 29 14:15:18 BST 2014, Jason Davies, Jason Davies, 18, 7, 25, 0, 1102
Thu Jul 17 23:58:17 BST 2014, Mike Bostock, Mike Bostock, 18, 11, 29, 0, 45
Thu Jul 17 06:25:23 BST 2014, Mike Bostock, Mike Bostock, 4, 4, 8, 0, 19
Thu Jun 19 20:04:05 BST 2014, Mike Bostock, Mike Bostock, 8, 1, 9, 0, 20
Sat Jul 12 07:01:16 BST 2014, Mike Bostock, Mike Bostock, 23, 43, 66, 0, 21
Sat Jul 12 07:00:28 BST 2014, Mike Bostock, Mike Bostock, 6, 15, 21, 0, 66
Sat Jul 12 06:56:49 BST 2014, Mike Bostock, Mike Bostock, 12, 23, 35, 0, 51
Sat Jul 12 06:56:12 BST 2014, Mike Bostock, Mike Bostock, 1, 1, 2, 0, 17
Sat Jul 12 05:48:40 BST 2014, Mike Bostock, Mike Bostock, 16, 0, 16, 0, 80
Mon Jul 07 05:36:25 BST 2014, Mike Bostock, Mike Bostock, 12, 23, 35, 0, 297
Tue Jul 01 11:01:40 BST 2014, José Romeu García, José Romeu García, 16, 0, 16, 0, 24
Mon Jun 30 18:16:59 BST 2014, Mike Bostock, Mike Bostock, 146, 155, 301, 0, 20
Mon Jun 30 18:15:31 BST 2014, Mike Bostock, Mike Bostock, 7, 0, 7, 0, 38
Mon Jun 30 18:14:09 BST 2014, Mike Bostock, Mike Bostock, 12, 3, 15, 0, 33
Mon Jun 30 18:13:30 BST 2014, Mike Bostock, Mike Bostock, 3, 3, 6, 0, 40
Mon Jun 30 18:12:58 BST 2014, Mike Bostock, Mike Bostock, 2, 2, 4, 0, 33
Mon Jun 30 18:10:04 BST 2014, Mike Bostock, Mike Bostock, 87, 144, 231, 0, 42
Mon Jun 30 11:41:19 BST 2014, Jason Davies, Jason Davies, 12, 3, 15, 0, 55
Fri Jun 27 17:19:42 BST 2014, Jason Davies, Jason Davies, 39, 7, 46, 0, 125
Wed Jun 25 00:43:37 BST 2014, Mike Bostock, Mike Bostock, 87, 144, 231, 0, 176
Tue Jun 24 15:21:49 BST 2014, Tim Branyen, Tim Branyen, 2, 2, 4, 0, 647
Sun Jun 08 11:05:34 BST 2014, Jason Davies, Jason Davies, 5, 7, 12, 0, 138
Sun Jun 08 04:42:03 BST 2014, Mike Bostock, Mike Bostock, 6, 10, 16, 0, 17
Sun Jun 08 00:31:42 BST 2014, Jason Davies, Jason Davies, 29, 13, 42, 0, 68
Sun Jun 08 00:17:39 BST 2014, Jason Davies, Jason Davies, 43, 26, 69, 0, 36
Fri Jun 06 18:02:08 BST 2014, Mike Bostock, Mike Bostock, 79, 5, 84, 0, 18
Fri May 30 17:00:01 BST 2014, Mike Bostock, Mike Bostock, 108, 13, 121, 0, 42
Wed May 28 10:29:56 BST 2014, Philip Jägenstedt, Philip Jägenstedt, 1, 1, 2, 0, 168
Fri May 23 09:55:35 BST 2014, Thomas Fankhauser, Thomas Fankhauser, 5, 5, 10, 0, 65
Thu May 22 11:31:22 BST 2014, afc163, afc163, 7, 0, 7, 0, 15
Mon May 19 19:25:57 BST 2014, Mike Bostock, Mike Bostock, 34, 17, 51, 0, 36
Mon May 19 19:25:22 BST 2014, Mike Bostock, Mike Bostock, 2, 6, 8, 0, 12
Mon May 19 18:37:01 BST 2014, Jason Davies, Jason Davies, 32, 11, 43, 0, 321
Mon May 19 05:42:53 BST 2014, Mike Bostock, Mike Bostock, 489, 481, 970, 0, 20
Mon May 19 05:41:34 BST 2014, Mike Bostock, Mike Bostock, 470, 471, 941, 0, 44
Mon May 19 05:40:34 BST 2014, Mike Bostock, Mike Bostock, 15, 6, 21, 0, 54
Thu May 15 06:49:56 BST 2014, ljani, Mike Bostock, 136, 0, 136, 0, 18
Mon May 19 04:52:11 BST 2014, Mike Bostock, Mike Bostock, 1, 1, 2, 0, 96
Sun May 18 23:08:16 BST 2014, Mike Bostock, Mike Bostock, 38, 74, 112, 0, 27
Sun May 18 16:10:02 BST 2014, Mike Bostock, Mike Bostock, 119, 116, 235, 0, 30
Sun May 18 06:25:28 BST 2014, Mike Bostock, Mike Bostock, 283, 291, 574, 0, 31
Sun May 18 06:25:28 BST 2014, Mike Bostock, Mike Bostock, 261, 232, 493, 0, 26
Sun May 18 04:32:59 BST 2014, Mike Bostock, Mike Bostock, 270, 259, 529, 0, 347
Tue May 13 22:21:37 BST 2014, Erin Jane, Erin Jane, 1, 1, 2, 0, 47
Sat May 10 17:25:53 BST 2014, Prajit Ramachandran, Prajit Ramachandran, 49, 7, 56, 0, 384
Tue Apr 22 20:13:58 BST 2014, Mike Bostock, Mike Bostock, 15, 6, 21, 2, 40
Mon Apr 14 04:55:29 BST 2014, Mike Bostock, Mike Bostock, 34, 37, 71, 0, 20
Mon Apr 14 04:54:52 BST 2014, Mike Bostock, Mike Bostock, 11, 15, 26, 0, 30
Mon Apr 14 04:54:19 BST 2014, Mike Bostock, Mike Bostock, 11, 9, 20, 0, 44
Mon Apr 14 04:53:34 BST 2014, Mike Bostock, Mike Bostock, 9, 10, 19, 0, 43
Fri Apr 11 14:02:34 BST 2014, Jason Davies, Jason Davies, 11, 15, 26, 0, 808
Fri Apr 11 00:43:16 BST 2014, Mike Bostock, Mike Bostock, 11, 9, 20, 0, 43
Thu Apr 10 22:34:40 BST 2014, Jason Davies, Jason Davies, 23, 23, 46, 0, 28
Tue Apr 08 16:03:44 BST 2014, Mike Bostock, Mike Bostock, 9, 10, 19, 0, 43
Tue Apr 08 05:43:32 BST 2014, Mike Bostock, Mike Bostock, 134, 147, 281, 0, 20
Tue Apr 08 05:41:17 BST 2014, Mike Bostock, Mike Bostock, 28, 15, 43, 0, 66
Sun Apr 06 06:24:21 BST 2014, Mike Bostock, Mike Bostock, 7, 17, 24, 0, 30
Sun Apr 06 06:05:11 BST 2014, Mike Bostock, Mike Bostock, 41, 0, 41, 0, 35
Sun Apr 06 05:50:33 BST 2014, Mike Bostock, Mike Bostock, 9, 8, 17, 0, 187
Sun Apr 06 05:29:31 BST 2014, Mike Bostock, Mike Bostock, 73, 131, 204, 0, 27
Fri Apr 04 14:29:23 BST 2014, Jason Davies, Jason Davies, 29, 16, 45, 0, 192
Tue Mar 25 03:45:44 GMT 2014, Mike Bostock, Mike Bostock, 518, 304, 822, 0, 20
Mon Mar 24 16:02:48 GMT 2014, Mike Bostock, Mike Bostock, 5, 5, 10, 0, 209
Mon Mar 24 05:57:35 GMT 2014, Mike Bostock, Mike Bostock, 27, 33, 60, 0, 17
Mon Mar 24 05:46:33 GMT 2014, Mike Bostock, Mike Bostock, 12, 3, 15, 0, 56
Mon Mar 24 05:42:28 GMT 2014, Mike Bostock, Mike Bostock, 5, 1, 6, 0, 61
Mon Mar 24 05:37:49 GMT 2014, Mike Bostock, Mike Bostock, 8, 6, 14, 0, 96
Mon Mar 24 05:29:17 GMT 2014, Mike Bostock, Mike Bostock, 11, 10, 21, 0, 269
Mon Mar 24 05:09:53 GMT 2014, Mike Bostock, Mike Bostock, 42, 37, 79, 0, 422
Mon Mar 24 04:37:34 GMT 2014, Mike Bostock, Mike Bostock, 52, 11, 63, 0, 277
Sun Mar 23 21:37:40 GMT 2014, Mike Bostock, Mike Bostock, 5, 3, 8, 0, 80
Sun Mar 23 21:10:55 GMT 2014, Mike Bostock, Mike Bostock, 98, 98, 196, 0, 279
Thu Feb 27 22:48:48 GMT 2014, Mike Bostock, Mike Bostock, 23, 25, 48, 0, 142
Tue Feb 04 19:50:09 GMT 2014, Darrick Brown, Mike Bostock, 12, 12, 24, 0, 116
Tue Jul 09 22:15:23 BST 2013, Timmy Willison, Mike Bostock, 3, 5, 8, 0, 34
Tue Jul 09 20:17:31 BST 2013, Timmy Willison, Mike Bostock, 7, 7, 14, 0, 39
Sun Mar 23 00:17:04 GMT 2014, Mike Bostock, Mike Bostock, 10, 3, 13, 0, 248
Thu Mar 20 18:31:20 GMT 2014, Mike Bostock, Mike Bostock, 7, 39, 46, 0, 115
Wed Mar 19 21:42:12 GMT 2014, Mike Bostock, Mike Bostock, 17, 13, 30, 0, 253
Wed Mar 19 21:00:58 GMT 2014, Mike Bostock, Mike Bostock, 100, 63, 163, 0, 397
Wed Mar 19 16:58:41 GMT 2014, Mike Bostock, Mike Bostock, 3, 1, 4, 0, 449
Mon Mar 17 04:05:12 GMT 2014, Mike Bostock, Mike Bostock, 8, 7, 15, 0, 177
Fri Mar 07 04:17:03 GMT 2014, Mike Bostock, Mike Bostock, 14, 14, 28, 0, 213
Thu Mar 06 17:58:37 GMT 2014, Mike Bostock, Mike Bostock, 173, 32, 205, 0, 707
Mon Mar 24 03:24:32 GMT 2014, Mike Bostock, Mike Bostock, 136, 0, 136, 0, 82
Sat Mar 22 14:35:26 GMT 2014, Mike Bostock, Mike Bostock, 12, 12, 24, 0, 116
Sat Mar 22 04:50:22 GMT 2014, Jim Kang, Jim Kang, 12, 12, 24, 0, 203
Fri Mar 21 21:04:36 GMT 2014, Roger Bramon, Roger Bramon, 136, 0, 136, 0, 26
Thu Mar 20 14:24:57 GMT 2014, Jason Davies, Jason Davies, 2, 2, 4, 0, 41
Thu Mar 20 14:20:55 GMT 2014, Jason Davies, Jason Davies, 17, 1, 18, 0, 86
Mon Mar 17 15:10:35 GMT 2014, Mike Bostock, Mike Bostock, 136, 0, 136, 0, 77
Mon Mar 17 13:11:34 GMT 2014, Fabricio Tavares de Oliveira, Fabricio Tavares de Oliveira, 136, 0, 136, 0, 95
Thu Mar 13 15:07:42 GMT 2014, Mike Bostock, Mike Bostock, 16, 0, 16, 0, 73
Thu Mar 13 13:30:06 GMT 2014, Alexander WU, Alexander WU, 16, 0, 16, 0, 26
Sun Mar 09 18:14:50 GMT 2014, Mike Bostock, Mike Bostock, 1, 1, 2, 0, 33
Thu Feb 27 15:50:18 GMT 2014, Mike Bostock, Mike Bostock, 21, 17, 38, 0, 23
Thu Feb 27 00:22:40 GMT 2014, Jason Davies, Jason Davies, 16, 12, 28, 0, 513
Tue Feb 18 16:39:33 GMT 2014, Mike Bostock, Mike Bostock, 38, 11, 49, 0, 25
Tue Feb 18 16:38:48 GMT 2014, Mike Bostock, Mike Bostock, 29, 9, 38, 1, 32
Tue Feb 18 16:19:56 GMT 2014, Mike Bostock, Mike Bostock, 9, 2, 11, 0, 65
Tue Feb 18 16:14:25 GMT 2014, Mike Bostock, Mike Bostock, 1, 1, 2, 0, 68
Wed Feb 12 02:29:15 GMT 2014, jbblanchet, jbblanchet, 5, 0, 5, 0, 34
Tue Feb 11 19:33:51 GMT 2014, jbblanchet, jbblanchet, 4, 2, 6, 0, 100
Mon Feb 03 10:04:15 GMT 2014, PatrickJS, PatrickJS, 1, 1, 2, 0, 21
Tue Jan 21 16:10:09 GMT 2014, Mike Bostock, Mike Bostock, 1, 0, 1, 0, 59
Tue Jan 21 02:51:51 GMT 2014, Jesus Magana, Jesus Magana, 1, 0, 1, 0, 9
Thu Jan 16 17:57:14 GMT 2014, Mike Bostock, Mike Bostock, 19, 0, 19, 0, 82
Wed Jan 15 22:34:25 GMT 2014, Mike Bostock, Mike Bostock, 1, 1, 2, 0, 25
Wed Jan 15 07:14:28 GMT 2014, kmindi, kmindi, 1, 1, 2, 0, 39
Tue Jan 14 23:15:26 GMT 2014, kmindi, kmindi, 1, 2, 3, 0, 44
Tue Jan 14 23:02:33 GMT 2014, kmindi, kmindi, 20, 0, 20, 0, 35
Mon Jan 13 19:39:15 GMT 2014, Mike Bostock, Mike Bostock, 32, 44, 76, 0, 112
Fri Jan 10 22:18:17 GMT 2014, Jason Davies, Jason Davies, 1, 1, 2, 0, 25
Fri Jan 10 17:52:03 GMT 2014, Mike Bostock, Mike Bostock, 4, 4, 8, 1, 41
Fri Jan 10 05:40:47 GMT 2014, Mike Bostock, Mike Bostock, 9, 10, 19, 0, 30
Fri Jan 10 00:44:43 GMT 2014, Mike Bostock, Mike Bostock, 3, 3, 6, 0, 40
Fri Jan 10 00:43:32 GMT 2014, Mike Bostock, Mike Bostock, 164, 56, 220, 0, 30
Fri Jan 10 00:38:12 GMT 2014, Mike Bostock, Mike Bostock, 10, 5, 15, 0, 30
Fri Jan 10 00:37:18 GMT 2014, Mike Bostock, Mike Bostock, 10, 5, 15, 0, 156
Thu Jan 09 23:36:18 GMT 2014, Mike Bostock, Mike Bostock, 6, 6, 12, 0, 20
Thu Jan 09 23:33:53 GMT 2014, Mike Bostock, Mike Bostock, 45, 27, 72, 0, 45
Thu Jan 09 23:33:19 GMT 2014, Mike Bostock, Mike Bostock, 6982, 6924, 13906, 0, 30
Thu Jan 09 23:32:48 GMT 2014, Mike Bostock, Mike Bostock, 226, 97, 323, 0, 38
Thu Jan 09 23:32:10 GMT 2014, Mike Bostock, Mike Bostock, 43, 28, 71, 0, 30
Thu Jan 09 23:31:05 GMT 2014, Mike Bostock, Mike Bostock, 135, 175, 310, 0, 73
Thu Jan 09 23:25:16 GMT 2014, Mike Bostock, Mike Bostock, 37, 50, 87, 0, 32
Thu Jan 09 23:14:25 GMT 2014, Mike Bostock, Mike Bostock, 127, 20, 147, 0, 82
Thu Jan 09 22:03:03 GMT 2014, Mike Bostock, Mike Bostock, 3, 1, 4, 0, 19
Thu Jan 09 21:54:49 GMT 2014, Mike Bostock, Mike Bostock, 41, 28, 69, 2, 327
Thu Jan 09 19:07:32 GMT 2014, Mike Bostock, Mike Bostock, 132, 1, 133, 0, 24
Thu Jan 09 18:50:11 GMT 2014, Mike Bostock, Mike Bostock, 32, 55, 87, 0, 150
Wed Jan 08 23:47:10 GMT 2014, Mike Bostock, Mike Bostock, 26, 0, 26, 0, 30
Wed Jan 08 23:30:21 GMT 2014, Mike Bostock, Mike Bostock, 74, 66, 140, 0, 226
Wed Jan 08 23:00:32 GMT 2014, Mike Bostock, Mike Bostock, 113, 120, 233, 0, 320
Wed Jan 08 22:45:44 GMT 2014, Mike Bostock, Mike Bostock, 16, 0, 16, 0, 33
Wed Jan 08 22:29:44 GMT 2014, Mike Bostock, Mike Bostock, 14, 13, 27, 0, 12
Wed Jan 08 22:21:24 GMT 2014, Mike Bostock, Mike Bostock, 775, 774, 1549, 0, 30
Fri Nov 29 17:09:51 GMT 2013, Mike Bostock, Mike Bostock, 1095, 1082, 2177, 0, 764
Wed Jan 08 21:04:12 GMT 2014, Mike Bostock, Mike Bostock, 72, 87, 159, 0, 27
Tue Dec 03 17:01:41 GMT 2013, Mike Bostock, Mike Bostock, 3, 3, 6, 0, 9
Tue Dec 03 16:59:45 GMT 2013, Mike Bostock, Mike Bostock, 78, 26, 104, 0, 102
Tue Dec 03 16:50:06 GMT 2013, Mike Bostock, Mike Bostock, 117, 25, 142, 0, 46
Mon Dec 16 17:24:53 GMT 2013, Mike Bostock, Mike Bostock, 19, 9, 28, 0, 43
Mon Dec 16 17:22:34 GMT 2013, Mike Bostock, Mike Bostock, 7, 8, 15, 0, 16
Mon Dec 16 01:06:57 GMT 2013, Stuart Glaser, Stuart Glaser, 6, 0, 6, 0, 43
Mon Dec 16 00:55:59 GMT 2013, Stuart Glaser, Stuart Glaser, 5, 0, 5, 0, 50
Sat Dec 14 00:06:11 GMT 2013, Mike Bostock, Mike Bostock, 77, 31, 108, 0, 21
Sat Dec 14 00:04:00 GMT 2013, Mike Bostock, Mike Bostock, 35, 20, 55, 0, 37
Sat Dec 14 00:03:09 GMT 2013, Mike Bostock, Mike Bostock, 28, 9, 37, 0, 38
Fri Dec 13 23:59:50 GMT 2013, Mike Bostock, Mike Bostock, 16, 4, 20, 0, 32
Fri Dec 13 23:57:10 GMT 2013, Mike Bostock, Mike Bostock, 28, 9, 37, 0, 112
Fri Dec 13 22:00:23 GMT 2013, Mike Bostock, Mike Bostock, 47, 59, 106, 0, 189
Thu Dec 12 23:36:35 GMT 2013, Mike Bostock, Mike Bostock, 42, 37, 79, 0, 43
Thu Dec 05 16:18:23 GMT 2013, Mike Bostock, Mike Bostock, 3, 3, 6, 0, 139
Thu Dec 05 08:05:38 GMT 2013, Daniel Goldbach, Daniel Goldbach, 3, 3, 6, 0, 70
Wed Dec 04 18:00:18 GMT 2013, Mike Bostock, Mike Bostock, 16, 4, 20, 0, 234
Wed Dec 04 13:41:34 GMT 2013, Daniel Goldbach, Daniel Goldbach, 1, 1, 2, 0, 22
Wed Dec 04 13:40:56 GMT 2013, Daniel Goldbach, Daniel Goldbach, 49, 42, 91, 0, 52
Wed Dec 04 13:03:12 GMT 2013, Daniel Goldbach, Daniel Goldbach, 21, 17, 38, 0, 358
Tue Dec 03 20:04:03 GMT 2013, Mike Bostock, Mike Bostock, 54, 32, 86, 0, 47
Tue Dec 03 16:23:14 GMT 2013, Mike Bostock, Mike Bostock, 8, 1, 9, 0, 81
Sat Nov 30 01:04:42 GMT 2013, Mike Bostock, Mike Bostock, 11, 11, 22, 0, 344
Mon Nov 25 12:26:45 GMT 2013, Guy Bedford, Guy Bedford, 8, 1, 9, 0, 31
Sun Nov 24 02:49:32 GMT 2013, Daniel Goldbach, Daniel Goldbach, 15, 16, 31, 0, 40
Sun Nov 24 02:14:12 GMT 2013, Daniel Goldbach, Daniel Goldbach, 6, 6, 12, 0, 29
Sun Nov 24 02:03:07 GMT 2013, Daniel Goldbach, Daniel Goldbach, 9, 2, 11, 0, 13
Sun Nov 24 02:02:42 GMT 2013, Daniel Goldbach, Daniel Goldbach, 16, 8, 24, 0, 35
Sat Nov 23 13:01:13 GMT 2013, Daniel Goldbach, Daniel Goldbach, 0, 2, 2, 0, 25
Sat Nov 23 11:15:04 GMT 2013, Daniel Goldbach, Daniel Goldbach, 0, 2, 2, 0, 52
Sat Nov 23 11:13:05 GMT 2013, Daniel Goldbach, Daniel Goldbach, 2, 0, 2, 0, 58
Sat Nov 23 11:11:59 GMT 2013, Daniel Goldbach, Daniel Goldbach, 7, 7, 14, 0, 51
Sat Nov 23 11:04:37 GMT 2013, Daniel Goldbach, Daniel Goldbach, 18, 0, 18, 0, 40
Sat Nov 23 10:51:33 GMT 2013, Daniel Goldbach, Daniel Goldbach, 41, 33, 74, 0, 62
Sat Nov 23 09:29:50 GMT 2013, Daniel Goldbach, Daniel Goldbach, 29, 71, 100, 0, 18
Sat Nov 23 09:15:16 GMT 2013, Daniel Goldbach, Daniel Goldbach, 7, 6, 13, 0, 41
Sat Nov 23 09:11:35 GMT 2013, Daniel Goldbach, Daniel Goldbach, 147, 11, 158, 0, 49
Wed Nov 20 23:25:24 GMT 2013, Mike Bostock, Mike Bostock, 1, 1, 2, 2, 16
Wed Nov 20 20:59:08 GMT 2013, Mike Bostock, Mike Bostock, 2, 0, 2, 0, 16
Tue Nov 19 17:19:00 GMT 2013, Mike Bostock, Mike Bostock, 36, 37, 73, 0, 21
Tue Nov 19 17:18:12 GMT 2013, Mike Bostock, Mike Bostock, 6, 6, 12, 0, 45
Tue Nov 19 17:17:26 GMT 2013, Mike Bostock, Mike Bostock, 4, 4, 8, 0, 47
Tue Nov 19 17:17:11 GMT 2013, Mike Bostock, Mike Bostock, 6, 6, 12, 0, 79
Sun Nov 17 17:11:37 GMT 2013, Mike Bostock, Mike Bostock, 4, 4, 8, 0, 421
Tue Nov 19 17:12:09 GMT 2013, Mike Bostock, Mike Bostock, 22, 34, 56, 0, 53
Sat Nov 09 09:53:19 GMT 2013, Jason Davies, Mike Bostock, 22, 11, 33, 0, 295
Tue Nov 19 16:37:28 GMT 2013, Mike Bostock, Mike Bostock, 7, 0, 7, 0, 55
Tue Nov 19 02:55:37 GMT 2013, Daniel Goldbach, Daniel Goldbach, 25, 0, 25, 0, 39
Tue Nov 19 02:54:32 GMT 2013, Daniel Goldbach, Daniel Goldbach, 27, 72, 99, 0, 18
Tue Nov 19 02:54:16 GMT 2013, Daniel Goldbach, Daniel Goldbach, 5, 4, 9, 0, 29
Tue Nov 19 02:47:48 GMT 2013, Daniel Goldbach, Daniel Goldbach, 6, 0, 6, 0, 20
Tue Nov 19 02:40:46 GMT 2013, Daniel Goldbach, Daniel Goldbach, 4, 2, 6, 0, 13
Tue Nov 19 02:39:57 GMT 2013, Daniel Goldbach, Daniel Goldbach, 3, 5, 8, 0, 24
Mon Nov 18 22:08:13 GMT 2013, Mike Bostock, Mike Bostock, 25, 0, 25, 0, 17
Mon Nov 18 15:56:17 GMT 2013, Daniel Goldbach, Daniel Goldbach, 0, 0, 0, 0, 76
Mon Nov 18 15:35:29 GMT 2013, Daniel Goldbach, Daniel Goldbach, 49, 80, 129, 0, 57
Mon Nov 18 15:35:29 GMT 2013, Daniel Goldbach, Daniel Goldbach, 49, 80, 129, 0, 23
Mon Nov 18 15:35:44 GMT 2013, Daniel Goldbach, Daniel Goldbach, 5, 5, 10, 0, 12
Fri Nov 15 10:43:23 GMT 2013, Guy Bedford, Guy Bedford, 5, 0, 5, 0, 28
Mon Nov 11 21:06:20 GMT 2013, Mike Bostock, Mike Bostock, 2, 2, 4, 0, 26
Mon Nov 04 20:03:23 GMT 2013, Nathan Vander Wilt, Nathan Vander Wilt, 4, 4, 8, 0, 18
Mon Nov 04 19:41:48 GMT 2013, Nathan Vander Wilt, Nathan Vander Wilt, 2, 2, 4, 0, 91
Fri Oct 25 23:36:50 BST 2013, Mike Bostock, Mike Bostock, 188, 84, 272, 0, 20
Fri Oct 25 23:35:59 BST 2013, Mike Bostock, Mike Bostock, 20, 15, 35, 0, 74
Fri Oct 25 23:35:22 BST 2013, Mike Bostock, Mike Bostock, 64, 11, 75, 0, 74
Fri Oct 25 22:53:47 BST 2013, Mike Bostock, Mike Bostock, 20, 15, 35, 1, 272
Thu Oct 17 17:11:22 BST 2013, Mike Bostock, Mike Bostock, 45, 29, 74, 0, 14
Thu Oct 17 16:58:19 BST 2013, Mike Bostock, Mike Bostock, 41, 4, 45, 0, 86
Thu Oct 17 01:32:04 BST 2013, Harry Voorhees, Harry Voorhees, 9, 5, 14, 0, 69
Thu Oct 17 01:12:08 BST 2013, Harry Voorhees, Harry Voorhees, 15, 18, 33, 0, 110
Thu Oct 17 00:10:20 BST 2013, Harry Voorhees, Harry Voorhees, 25, 21, 46, 0, 92
Wed Oct 16 17:13:43 BST 2013, Mike Bostock, Mike Bostock, 84, 84, 168, 0, 313
Wed Oct 16 16:47:09 BST 2013, Mike Bostock, Mike Bostock, 73, 55, 128, 0, 28
Tue Oct 15 22:43:09 BST 2013, Jason Davies, Jason Davies, 63, 35, 98, 0, 277
Mon Oct 14 16:56:31 BST 2013, Mike Bostock, Mike Bostock, 357, 322, 679, 0, 20
Mon Oct 14 16:55:15 BST 2013, Mike Bostock, Mike Bostock, 21, 11, 32, 0, 67
Mon Oct 14 16:54:43 BST 2013, Mike Bostock, Mike Bostock, 306, 289, 595, 0, 62
Sat Oct 12 05:24:28 BST 2013, Mike Bostock, Mike Bostock, 7, 2, 9, 0, 41
Sat Oct 12 05:21:26 BST 2013, Mike Bostock, Mike Bostock, 5, 7, 12, 0, 19
Sat Oct 12 05:06:01 BST 2013, Mike Bostock, Mike Bostock, 10, 4, 14, 0, 28
Fri Oct 11 19:40:10 BST 2013, Mike Bostock, Mike Bostock, 18, 16, 34, 0, 216
Fri Oct 11 16:11:04 BST 2013, Jason Davies, Jason Davies, 299, 287, 586, 0, 119
Fri Oct 11 11:41:55 BST 2013, Jason Davies, Jason Davies, 17, 5, 22, 0, 317
Fri Oct 11 04:53:19 BST 2013, Mike Bostock, Mike Bostock, 2, 2, 4, 0, 42
Fri Oct 11 04:51:20 BST 2013, Mike Bostock, Mike Bostock, 10, 0, 10, 0, 36
Fri Oct 11 04:49:09 BST 2013, Mike Bostock, Mike Bostock, 11, 3186, 3197, 0, 50
Fri Oct 11 01:19:13 BST 2013, Mike Bostock, Mike Bostock, 184, 256, 440, 0, 226
Fri Oct 11 00:46:19 BST 2013, Mike Bostock, Mike Bostock, 2175, 1443, 3618, 0, 20
Thu Oct 10 16:44:29 BST 2013, Mike Bostock, Mike Bostock, 30, 29, 59, 0, 20
Thu Oct 10 16:36:59 BST 2013, Mike Bostock, Mike Bostock, 60, 60, 120, 0, 20
Thu Oct 10 16:26:30 BST 2013, Mike Bostock, Mike Bostock, 26, 27, 53, 0, 19
Thu Oct 10 06:11:07 BST 2013, Mike Bostock, Mike Bostock, 5, 7, 12, 0, 20
Thu Oct 10 05:22:44 BST 2013, Mike Bostock, Mike Bostock, 3, 3, 6, 0, 283
Thu Oct 10 00:53:12 BST 2013, Mike Bostock, Mike Bostock, 7, 12, 19, 0, 8
Thu Oct 10 00:46:23 BST 2013, Mike Bostock, Mike Bostock, 25, 27, 52, 0, 344
Wed Oct 09 22:43:35 BST 2013, Mike Bostock, Mike Bostock, 43, 32, 75, 0, 106
Wed Oct 09 20:30:28 BST 2013, Harry Voorhees, Harry Voorhees, 24, 4, 28, 0, 64
Wed Oct 09 17:09:48 BST 2013, Harry Voorhees, Harry Voorhees, 10, 0, 10, 0, 101
Wed Oct 09 17:07:16 BST 2013, Mike Bostock, Mike Bostock, 19, 16, 35, 0, 17
Wed Oct 09 16:43:03 BST 2013, Mike Bostock, Mike Bostock, 4, 3, 7, 0, 17
Wed Oct 09 16:37:37 BST 2013, Mike Bostock, Mike Bostock, 55, 11, 66, 0, 226
Wed Oct 09 16:13:22 BST 2013, Mike Bostock, Mike Bostock, 24, 16, 40, 0, 25
Wed Oct 09 16:10:05 BST 2013, Mike Bostock, Mike Bostock, 6, 6, 12, 0, 13
Wed Oct 09 16:09:35 BST 2013, Mike Bostock, Mike Bostock, 9, 9, 18, 0, 67
Wed Oct 09 16:09:07 BST 2013, Mike Bostock, Mike Bostock, 3, 3, 6, 0, 70
Wed Oct 09 16:08:27 BST 2013, Mike Bostock, Mike Bostock, 17, 24, 41, 0, 52
Wed Oct 09 16:07:55 BST 2013, Mike Bostock, Mike Bostock, 291, 223, 514, 0, 100
Wed Oct 09 15:57:55 BST 2013, Mike Bostock, Mike Bostock, 6, 6, 12, 0, 183
Wed Oct 09 15:42:04 BST 2013, Harry Voorhees, Harry Voorhees, 2, 0, 2, 0, 69
Mon Oct 07 23:27:41 BST 2013, Mike Bostock, Mike Bostock, 3, 3, 6, 0, 45
Mon Oct 07 17:06:01 BST 2013, Mike Bostock, Mike Bostock, 6, 9, 15, 0, 9
Mon Oct 07 17:00:34 BST 2013, Mike Bostock, Mike Bostock, 65, 66, 131, 0, 9
Sat Oct 05 23:26:47 BST 2013, Jason Davies, Jason Davies, 9, 9, 18, 0, 251
Sat Oct 05 22:59:03 BST 2013, Mike Bostock, Mike Bostock, 18, 6, 24, 0, 37
Sat Oct 05 22:39:31 BST 2013, Mike Bostock, Mike Bostock, 4, 4, 8, 0, 25
Sat Oct 05 21:50:13 BST 2013, Jason Davies, Mike Bostock, 3, 3, 6, 0, 18
Sat Oct 05 21:47:23 BST 2013, Jason Davies, Mike Bostock, 5, 11, 16, 0, 9
Sat Oct 05 21:43:38 BST 2013, Jason Davies, Mike Bostock, 3, 7, 10, 0, 148
Sat Oct 05 21:28:15 BST 2013, Mike Bostock, Mike Bostock, 3, 3, 6, 0, 27
Sat Oct 05 21:17:21 BST 2013, Jason Davies, Mike Bostock, 7, 3, 10, 0, 28
Sat Oct 05 21:05:13 BST 2013, Jason Davies, Mike Bostock, 15, 9, 24, 0, 165
Sat Oct 05 19:15:43 BST 2013, Mike Bostock, Mike Bostock, 50, 7, 57, 0, 27
Thu Oct 03 05:04:00 BST 2013, Mike Bostock, Mike Bostock, 45, 27, 72, 0, 22
Tue Sep 24 21:58:32 BST 2013, Mike Bostock, Mike Bostock, 215, 153, 368, 0, 73
Tue Sep 24 21:22:13 BST 2013, Mike Bostock, Mike Bostock, 24, 0, 24, 0, 22
Tue Sep 24 19:10:09 BST 2013, Mike Bostock, Mike Bostock, 5, 5, 10, 0, 8
Tue Sep 24 19:07:51 BST 2013, Mike Bostock, Mike Bostock, 13, 18, 31, 0, 8
Tue Sep 24 19:05:14 BST 2013, Mike Bostock, Mike Bostock, 20, 16, 36, 0, 8
Tue Sep 24 19:01:53 BST 2013, Mike Bostock, Mike Bostock, 10, 27, 37, 0, 8
Tue Sep 24 18:58:59 BST 2013, Mike Bostock, Mike Bostock, 11, 14, 25, 0, 8
Tue Sep 24 18:51:24 BST 2013, Mike Bostock, Mike Bostock, 6, 6, 12, 0, 8
Mon Sep 23 19:36:37 BST 2013, Mike Bostock, Mike Bostock, 3, 3, 6, 0, 41
Mon Sep 23 17:54:09 BST 2013, Mike Bostock, Mike Bostock, 11, 11, 22, 0, 38
Mon Sep 23 17:47:45 BST 2013, Mike Bostock, Mike Bostock, 60, 59, 119, 0, 42
Mon Sep 23 17:40:07 BST 2013, Mike Bostock, Mike Bostock, 3, 3, 6, 0, 17
Mon Sep 23 17:02:20 BST 2013, Mike Bostock, Mike Bostock, 119, 177, 296, 0, 50
Mon Sep 23 09:02:21 BST 2013, Mike Bostock, Mike Bostock, 15, 22, 37, 0, 17
Mon Sep 23 08:50:06 BST 2013, Mike Bostock, Mike Bostock, 3, 5, 8, 0, 8
Mon Sep 23 08:30:13 BST 2013, Mike Bostock, Mike Bostock, 15, 15, 30, 0, 12
Mon Sep 23 08:27:02 BST 2013, Mike Bostock, Mike Bostock, 91, 86, 177, 0, 42
Mon Sep 23 08:06:38 BST 2013, Mike Bostock, Mike Bostock, 5, 9, 14, 0, 8
Mon Sep 23 07:56:37 BST 2013, Mike Bostock, Mike Bostock, 3, 3, 6, 0, 31
Mon Sep 23 07:56:20 BST 2013, Mike Bostock, Mike Bostock, 0, 27, 27, 0, 24
Mon Sep 23 07:53:49 BST 2013, Mike Bostock, Mike Bostock, 103, 95, 198, 0, 15
Mon Sep 23 07:48:56 BST 2013, Mike Bostock, Mike Bostock, 16, 16, 32, 0, 14
Mon Sep 23 07:46:25 BST 2013, Mike Bostock, Mike Bostock, 34, 34, 68, 0, 14
Mon Sep 23 07:39:45 BST 2013, Mike Bostock, Mike Bostock, 84, 90, 174, 0, 31
Mon Sep 23 07:36:31 BST 2013, Mike Bostock, Mike Bostock, 57, 58, 115, 0, 16
Mon Sep 23 07:32:42 BST 2013, Mike Bostock, Mike Bostock, 10, 10, 20, 0, 14
Mon Sep 23 07:30:08 BST 2013, Mike Bostock, Mike Bostock, 343, 343, 686, 0, 19
Mon Sep 23 07:24:52 BST 2013, Mike Bostock, Mike Bostock, 447, 449, 896, 0, 19
Mon Sep 23 06:46:04 BST 2013, Mike Bostock, Mike Bostock, 61, 61, 122, 0, 21
Mon Sep 23 06:43:11 BST 2013, Mike Bostock, Mike Bostock, 129, 147, 276, 0, 39
Mon Sep 23 06:29:39 BST 2013, Mike Bostock, Mike Bostock, 30, 40, 70, 0, 13
Mon Sep 23 06:22:20 BST 2013, Mike Bostock, Mike Bostock, 1321, 2248, 3569, 0, 47
Mon Sep 23 01:15:14 BST 2013, Mike Bostock, Mike Bostock, 971, 959, 1930, 0, 188
Sun Sep 22 17:58:03 BST 2013, Mike Bostock, Mike Bostock, 1515, 0, 1515, 0, 22
Sat Oct 05 18:31:24 BST 2013, Mike Bostock, Mike Bostock, 16, 23, 39, 0, 61
Thu Oct 03 21:08:48 BST 2013, Jason Davies, Jason Davies, 5, 5, 10, 0, 9
Thu Oct 03 19:34:18 BST 2013, Jason Davies, Jason Davies, 53, 61, 114, 0, 9
Thu Oct 03 17:20:44 BST 2013, Jason Davies, Jason Davies, 10, 9, 19, 0, 25
Thu Oct 03 15:46:22 BST 2013, Jason Davies, Jason Davies, 259, 184, 443, 1, 418
Thu Sep 26 22:38:51 BST 2013, Mike Bostock, Mike Bostock, 241, 197, 438, 0, 20
Thu Sep 26 22:38:01 BST 2013, Mike Bostock, Mike Bostock, 6, 6, 12, 11, 20
Thu Sep 26 22:26:06 BST 2013, Mike Bostock, Mike Bostock, 9, 9, 18, 0, 78
Thu Sep 26 22:08:16 BST 2013, Mike Bostock, Mike Bostock, 30, 35, 65, 0, 250
Thu Sep 26 15:52:02 BST 2013, Jason Davies, Jason Davies, 34, 39, 73, 0, 1309
Wed Sep 25 20:53:21 BST 2013, Mike Bostock, Mike Bostock, 76, 26, 102, 0, 64
Wed Sep 25 20:00:50 BST 2013, Mike Bostock, Mike Bostock, 7, 7, 14, 0, 102
Wed Sep 25 19:44:50 BST 2013, Mike Bostock, Mike Bostock, 2, 3, 5, 0, 15
Wed Sep 25 19:43:53 BST 2013, Mike Bostock, Mike Bostock, 53, 49, 102, 1, 6
Wed Sep 25 19:39:46 BST 2013, Mike Bostock, Mike Bostock, 3, 5, 8, 1, 12
Wed Sep 25 19:24:28 BST 2013, Jason Davies, Jason Davies, 17, 31, 48, 0, 9
Wed Sep 25 19:15:32 BST 2013, Jason Davies, Jason Davies, 21, 24, 45, 0, 35
Wed Sep 25 05:31:08 BST 2013, Mike Bostock, Mike Bostock, 3, 3, 6, 0, 174
Wed Sep 25 05:21:10 BST 2013, Mike Bostock, Mike Bostock, 7, 7, 14, 0, 9
Tue Sep 24 20:03:05 BST 2013, Jason Davies, Jason Davies, 56, 36, 92, 0, 609
Tue Sep 24 20:08:33 BST 2013, Jason Davies, Jason Davies, 23, 19, 42, 0, 9
Tue Sep 24 18:49:46 BST 2013, Jason Davies, Jason Davies, 74, 28, 102, 0, 349
Sat Sep 21 19:49:09 BST 2013, Mike Bostock, Mike Bostock, 66, 33, 99, 0, 42
Sat Sep 21 18:31:07 BST 2013, Mike Bostock, Mike Bostock, 61, 28, 89, 0, 664
Thu Sep 19 04:52:44 BST 2013, Mike Bostock, Mike Bostock, 66, 36, 102, 0, 20
Thu Sep 19 04:51:35 BST 2013, Mike Bostock, Mike Bostock, 11, 3, 14, 0, 74
Thu Sep 19 04:50:30 BST 2013, Mike Bostock, Mike Bostock, 5, 5, 10, 0, 66
Thu Sep 19 04:50:12 BST 2013, Mike Bostock, Mike Bostock, 44, 19, 63, 0, 60
Thu Sep 19 04:35:27 BST 2013, Mike Bostock, Mike Bostock, 11, 3, 14, 0, 186
Thu Sep 19 04:06:37 BST 2013, Mike Bostock, Mike Bostock, 5, 5, 10, 6, 579
Mon Sep 16 22:30:20 BST 2013, Jason Davies, Jason Davies, 44, 19, 63, 0, 757
Thu Sep 05 21:31:03 BST 2013, Jason Davies, Jason Davies, 1, 4, 5, 0, 255
Thu Sep 05 19:53:01 BST 2013, Jason Davies, Jason Davies, 3, 3, 6, 0, 45
Thu Sep 05 19:21:15 BST 2013, Mike Bostock, Mike Bostock, 133, 85, 218, 0, 20
Thu Sep 05 19:20:40 BST 2013, Mike Bostock, Mike Bostock, 77, 44, 121, 0, 39
Thu Sep 05 19:20:07 BST 2013, Mike Bostock, Mike Bostock, 46, 14, 60, 0, 41
Thu Sep 05 18:52:56 BST 2013, Mike Bostock, Mike Bostock, 5, 14, 19, 0, 154
Thu Sep 05 18:31:39 BST 2013, Mike Bostock, Mike Bostock, 7, 15, 22, 0, 398
Thu Sep 05 06:37:25 BST 2013, Mike Bostock, Mike Bostock, 13, 6, 19, 0, 19
Sat Aug 31 16:34:03 BST 2013, Jason Davies, Jason Davies, 3, 3, 6, 0, 79
Sat Aug 31 15:10:00 BST 2013, Jason Davies, Jason Davies, 20, 13, 33, 1, 274
Sat Aug 31 11:10:10 BST 2013, Jason Davies, Jason Davies, 6, 6, 12, 0, 23
Sat Aug 31 01:29:59 BST 2013, Jason Davies, Jason Davies, 9, 9, 18, 0, 181
Sat Aug 31 01:09:24 BST 2013, Jason Davies, Jason Davies, 4, 11, 15, 0, 294
Sat Aug 31 00:30:26 BST 2013, Jason Davies, Jason Davies, 13, 5, 18, 1, 220
Fri Aug 30 23:10:48 BST 2013, Jason Davies, Jason Davies, 48, 23, 71, 0, 326
Wed Aug 28 10:01:22 BST 2013, Jason Davies, Jason Davies, 39, 14, 53, 0, 172
Tue Aug 27 06:39:58 BST 2013, Mike Bostock, Mike Bostock, 39, 39, 78, 3, 383
Fri Aug 23 22:18:53 BST 2013, Mike Bostock, Mike Bostock, 6, 6, 12, 0, 13
Fri Aug 23 22:17:53 BST 2013, Mike Bostock, Mike Bostock, 11, 7, 18, 0, 69
Fri Aug 23 22:17:12 BST 2013, Mike Bostock, Mike Bostock, 11, 4, 15, 0, 67
Fri Aug 23 22:15:30 BST 2013, Mike Bostock, Mike Bostock, 4, 4, 8, 0, 106
Fri Aug 23 21:09:32 BST 2013, Jason Davies, Jason Davies, 4, 4, 8, 0, 9
Fri Aug 23 19:59:42 BST 2013, Jason Davies, Jason Davies, 1, 1, 2, 0, 14
Fri Aug 23 18:51:59 BST 2013, Jason Davies, Jason Davies, 12, 5, 17, 0, 46
Fri Aug 23 00:49:57 BST 2013, Mike Bostock, Mike Bostock, 28, 27, 55, 0, 28
Thu Aug 22 23:55:57 BST 2013, Mike Bostock, Mike Bostock, 39, 22, 61, 0, 22
Thu Aug 22 09:19:41 BST 2013, Jason Davies, Jason Davies, 7, 3, 10, 0, 206
Thu Aug 22 05:08:52 BST 2013, Mike Bostock, Mike Bostock, 6, 6, 12, 0, 14
Thu Aug 22 05:05:22 BST 2013, Mike Bostock, Mike Bostock, 3, 3, 6, 0, 36
Thu Aug 22 04:59:43 BST 2013, Mike Bostock, Mike Bostock, 138, 21, 159, 0, 59
Wed Aug 21 20:16:21 BST 2013, Mike Bostock, Mike Bostock, 8, 8, 16, 0, 19
Wed Aug 21 20:08:37 BST 2013, Mike Bostock, Mike Bostock, 203, 199, 402, 0, 31
Wed Aug 21 19:57:51 BST 2013, Mike Bostock, Mike Bostock, 6, 10, 16, 0, 18
Wed Aug 21 19:47:41 BST 2013, Mike Bostock, Mike Bostock, 65, 95, 160, 0, 45
Mon Aug 19 19:13:10 BST 2013, Mike Bostock, Mike Bostock, 9, 9, 18, 0, 19
Mon Aug 19 19:06:53 BST 2013, Mike Bostock, Mike Bostock, 43, 5, 48, 0, 13
Mon Aug 19 18:50:09 BST 2013, Mike Bostock, Mike Bostock, 188, 118, 306, 0, 267
Fri Aug 16 23:13:31 BST 2013, Mike Bostock, Mike Bostock, 85, 135, 220, 0, 50
Fri Aug 16 19:34:51 BST 2013, Mike Bostock, Mike Bostock, 15, 14, 29, 0, 333
Fri Aug 16 18:25:07 BST 2013, Mike Bostock, Mike Bostock, 108, 112, 220, 0, 554
Thu Aug 15 22:55:40 BST 2013, Mike Bostock, Mike Bostock, 97, 82, 179, 1, 229
Thu Aug 15 20:09:33 BST 2013, Mike Bostock, Mike Bostock, 10, 10, 20, 0, 306
Thu Aug 15 18:03:30 BST 2013, Mike Bostock, Mike Bostock, 30, 28, 58, 0, 264
Thu Aug 15 17:27:52 BST 2013, Mike Bostock, Mike Bostock, 11, 12, 23, 0, 291
Thu Aug 15 17:22:10 BST 2013, Mike Bostock, Mike Bostock, 42, 24, 66, 0, 532
Thu Aug 15 04:55:29 BST 2013, Mike Bostock, Mike Bostock, 5, 5, 10, 0, 27
Thu Aug 15 04:52:57 BST 2013, Mike Bostock, Mike Bostock, 62, 55, 117, 0, 17
Thu Aug 15 04:47:49 BST 2013, Mike Bostock, Mike Bostock, 8, 3, 11, 0, 39
Thu Aug 15 04:07:14 BST 2013, Mike Bostock, Mike Bostock, 138, 43, 181, 0, 166
Wed Aug 14 23:50:31 BST 2013, Mike Bostock, Mike Bostock, 121, 54, 175, 0, 30
Thu Aug 15 01:19:58 BST 2013, Mike Bostock, Mike Bostock, 26, 23, 49, 0, 308
Wed Aug 14 21:38:21 BST 2013, Mike Bostock, Mike Bostock, 6, 3, 9, 0, 37
Wed Aug 14 21:08:10 BST 2013, Mike Bostock, Mike Bostock, 56, 44, 100, 0, 784
Wed Aug 14 17:58:28 BST 2013, Mike Bostock, Mike Bostock, 3, 2, 5, 0, 39
Tue Aug 13 22:37:08 BST 2013, Mike Bostock, Mike Bostock, 32, 22, 54, 0, 35
Tue Aug 13 22:19:07 BST 2013, Mike Bostock, Mike Bostock, 6, 6, 12, 0, 13
Tue Aug 13 22:17:26 BST 2013, Mike Bostock, Mike Bostock, 172, 182, 354, 0, 68
Tue Aug 13 22:16:39 BST 2013, Mike Bostock, Mike Bostock, 21, 7, 28, 0, 69
Tue Aug 13 22:13:55 BST 2013, Mike Bostock, Mike Bostock, 36, 2, 38, 0, 59
Tue Aug 13 22:13:21 BST 2013, Mike Bostock, Mike Bostock, 37, 19, 56, 0, 34
Tue Aug 13 22:12:43 BST 2013, Mike Bostock, Mike Bostock, 45, 13, 58, 0, 38
Tue Aug 13 22:12:06 BST 2013, Mike Bostock, Mike Bostock, 66, 21, 87, 0, 35
Tue Aug 13 19:00:38 BST 2013, Mike Bostock, Mike Bostock, 142, 103, 245, 0, 39
Tue Aug 13 18:07:51 BST 2013, Mike Bostock, Mike Bostock, 25, 11, 36, 0, 87
Tue Aug 13 01:08:58 BST 2013, Mike Bostock, Mike Bostock, 10, 14, 24, 0, 43
Tue Aug 13 00:50:08 BST 2013, Mike Bostock, Mike Bostock, 4, 14, 18, 0, 47
Tue Aug 13 00:47:39 BST 2013, Mike Bostock, Mike Bostock, 14, 9, 23, 0, 9
Tue Aug 13 00:39:23 BST 2013, Mike Bostock, Mike Bostock, 5, 1, 6, 0, 43
Tue Aug 13 00:32:40 BST 2013, Mike Bostock, Mike Bostock, 6, 10, 16, 0, 27
Mon Aug 12 22:37:24 BST 2013, Mike Bostock, Mike Bostock, 66, 6, 72, 0, 174
Sun Aug 11 08:13:24 BST 2013, Mike Bostock, Mike Bostock, 44, 34, 78, 0, 253
Fri Aug 09 20:34:41 BST 2013, Mike Bostock, Mike Bostock, 75, 22, 97, 0, 155
Mon Aug 12 16:17:45 BST 2013, Mike Bostock, Mike Bostock, 3, 3, 6, 0, 39
Sat Aug 10 18:23:24 BST 2013, Mike Bostock, Mike Bostock, 155, 68, 223, 0, 44
Sat Jun 29 18:12:34 BST 2013, Mike Bostock, Mike Bostock, 64, 161, 225, 0, 39
Sat Aug 10 05:09:43 BST 2013, Mike Bostock, Mike Bostock, 66, 21, 87, 0, 46
Sat Aug 10 04:52:03 BST 2013, Mike Bostock, Mike Bostock, 9, 9, 18, 0, 14
Sat Aug 10 04:32:19 BST 2013, Mike Bostock, Mike Bostock, 36, 6, 42, 0, 33
Sat Aug 10 04:19:52 BST 2013, Mike Bostock, Mike Bostock, 7, 5, 12, 0, 90
Mon Aug 05 18:47:22 BST 2013, Mike Bostock, Mike Bostock, 3, 5, 8, 0, 15
Mon Aug 05 18:44:59 BST 2013, Mike Bostock, Mike Bostock, 38, 2, 40, 0, 187
Fri Aug 02 23:03:24 BST 2013, Mike Bostock, Mike Bostock, 37, 19, 56, 0, 250
Thu Aug 01 15:37:51 BST 2013, Mike Bostock, Mike Bostock, 141, 93, 234, 0, 20
Thu Aug 01 15:37:00 BST 2013, Mike Bostock, Mike Bostock, 15, 4, 19, 0, 46
Thu Aug 01 15:36:26 BST 2013, Mike Bostock, Mike Bostock, 84, 53, 137, 0, 40
Thu Aug 01 15:36:02 BST 2013, Mike Bostock, Mike Bostock, 19, 11, 30, 0, 50
Thu Aug 01 15:35:21 BST 2013, Mike Bostock, Mike Bostock, 9, 9, 18, 0, 39
Thu Aug 01 15:33:51 BST 2013, Mike Bostock, Mike Bostock, 3, 4, 7, 0, 12
Thu Aug 01 15:31:35 BST 2013, Mike Bostock, Mike Bostock, 3, 3, 6, 0, 38
Thu Aug 01 15:30:31 BST 2013, Mike Bostock, Mike Bostock, 5, 5, 10, 0, 38
Thu Aug 01 15:29:32 BST 2013, Mike Bostock, Mike Bostock, 12, 12, 24, 0, 110
Thu Aug 01 15:28:49 BST 2013, Mike Bostock, Mike Bostock, 2, 2, 4, 0, 110
Thu Aug 01 15:27:59 BST 2013, Mike Bostock, Mike Bostock, 9, 10, 19, 0, 78
Wed Jul 31 22:39:01 BST 2013, Jason Davies, Jason Davies, 3, 3, 6, 0, 19
Wed Jul 31 22:31:22 BST 2013, Mike Bostock, Mike Bostock, 29, 24, 53, 0, 21
Wed Jul 31 21:28:41 BST 2013, Jason Davies, Jason Davies, 13, 9, 22, 0, 19
Wed Jul 31 19:00:11 BST 2013, Mike Bostock, Mike Bostock, 7, 7, 14, 0, 33
Wed Jul 31 18:40:07 BST 2013, Mike Bostock, Mike Bostock, 10, 0, 10, 0, 41
Mon Jul 29 21:27:08 BST 2013, Leonardo Dutra, Leonardo Dutra, 2, 2, 4, 0, 18
Mon Jul 29 21:25:05 BST 2013, Leonardo Dutra, Leonardo Dutra, 3, 2, 5, 0, 16
Sun Jul 28 21:46:17 BST 2013, adnan, adnan, 8, 6, 14, 0, 40
Wed Jul 24 22:39:27 BST 2013, Leonardo Dutra, Leonardo Dutra, 1, 1, 2, 0, 19
Wed Jul 24 22:04:52 BST 2013, Leonardo Dutra, Leonardo Dutra, 2, 2, 4, 0, 104
Wed Jul 24 21:59:28 BST 2013, Leonardo Dutra, Leonardo Dutra, 1, 1, 2, 0, 52
Wed Jul 24 21:51:35 BST 2013, Leonardo Dutra, Leonardo Dutra, 3, 4, 7, 0, 130
Wed Jul 24 20:01:18 BST 2013, Leonardo Dutra, Leonardo Dutra, 1, 1, 2, 0, 98
Wed Jul 24 19:58:58 BST 2013, Leonardo Dutra, Leonardo Dutra, 1, 1, 2, 0, 137
Wed Jul 24 19:11:45 BST 2013, Mike Bostock, Mike Bostock, 19, 11, 30, 0, 181
Tue Jul 23 23:23:38 BST 2013, Jason Davies, Jason Davies, 70, 49, 119, 0, 492
Tue Jul 23 19:52:51 BST 2013, Jason Davies, Jason Davies, 6, 5, 11, 0, 762
Mon Jul 22 12:55:24 BST 2013, Mike Bostock, Mike Bostock, 3, 3, 6, 0, 267
Sun Jul 21 17:55:17 BST 2013, Mike Bostock, Mike Bostock, 16, 5, 21, 0, 36
Fri Jul 19 04:30:09 BST 2013, Mike Bostock, Mike Bostock, 5, 4, 9, 0, 35
Fri Jul 19 04:17:22 BST 2013, Mike Bostock, Mike Bostock, 525, 546, 1071, 0, 20
Fri Jul 19 04:15:03 BST 2013, Mike Bostock, Mike Bostock, 3, 3, 6, 0, 45
Fri Jul 19 04:14:37 BST 2013, Mike Bostock, Mike Bostock, 51, 47, 98, 0, 55
Fri Jul 19 04:14:06 BST 2013, Mike Bostock, Mike Bostock, 16, 18, 34, 0, 46
Fri Jul 19 04:13:40 BST 2013, Mike Bostock, Mike Bostock, 10, 14, 24, 0, 47
Fri Jul 19 03:53:21 BST 2013, Mike Bostock, Mike Bostock, 99, 127, 226, 0, 426
Fri Jul 12 23:04:43 BST 2013, Mike Bostock, Mike Bostock, 350, 341, 691, 0, 21
Fri Jul 19 01:56:25 BST 2013, Mike Bostock, Mike Bostock, 14, 18, 32, 0, 172
Thu Jul 18 21:25:38 BST 2013, Mike Bostock, Mike Bostock, 15, 20, 35, 0, 304
Thu Jul 18 20:07:41 BST 2013, Mike Bostock, Mike Bostock, 6, 3, 9, 0, 60
Thu Jul 18 18:07:14 BST 2013, Mike Bostock, Mike Bostock, 51, 47, 98, 0, 239
Tue Jul 16 18:48:46 BST 2013, Mike Bostock, Mike Bostock, 3, 3, 6, 0, 322
Fri Jul 12 17:38:35 BST 2013, Mike Bostock, Mike Bostock, 35, 10, 45, 0, 13
Fri Jul 12 01:21:38 BST 2013, Mike Bostock, Mike Bostock, 4, 2, 6, 0, 26
Fri Jul 12 00:54:20 BST 2013, Mike Bostock, Mike Bostock, 341, 322, 663, 0, 20
Fri Jul 12 00:53:02 BST 2013, Mike Bostock, Mike Bostock, 88, 102, 190, 0, 48
Fri Jul 12 00:52:23 BST 2013, Mike Bostock, Mike Bostock, 223, 196, 419, 0, 49
Fri Jul 12 00:51:38 BST 2013, Mike Bostock, Mike Bostock, 31, 25, 56, 0, 53
Thu Jul 11 23:19:33 BST 2013, Mike Bostock, Mike Bostock, 13, 13, 26, 0, 9
Thu Jul 11 21:48:46 BST 2013, Mike Bostock, Mike Bostock, 32, 8, 40, 0, 38
Thu Jul 11 20:55:34 BST 2013, Mike Bostock, Mike Bostock, 58, 96, 154, 0, 44
Thu Jul 11 05:49:44 BST 2013, Mike Bostock, Mike Bostock, 0, 1, 1, 0, 22
Thu Jul 11 05:48:37 BST 2013, Mike Bostock, Mike Bostock, 0, 1, 1, 0, 46
Thu Jul 11 02:05:38 BST 2013, Mike Bostock, Mike Bostock, 33, 29, 62, 0, 524
Wed Jul 10 18:47:06 BST 2013, Mike Bostock, Mike Bostock, 127, 110, 237, 0, 899
Wed Jul 10 18:04:21 BST 2013, Mike Bostock, Mike Bostock, 91, 86, 177, 0, 323
Wed Jul 10 17:02:10 BST 2013, Mike Bostock, Mike Bostock, 10, 9, 19, 0, 347
Sat Jul 06 22:55:44 BST 2013, Mike Bostock, Mike Bostock, 12, 12, 24, 0, 22
Sat Jul 06 22:52:59 BST 2013, Mike Bostock, Mike Bostock, 22, 16, 38, 0, 400
Sat Jul 06 04:13:41 BST 2013, Mike Bostock, Mike Bostock, 12, 14, 26, 0, 42
Fri Jul 05 23:39:56 BST 2013, Jason Davies, Jason Davies, 1, 1, 2, 0, 34
Fri Jul 05 23:34:17 BST 2013, Jason Davies, Jason Davies, 22, 7, 29, 0, 460
Fri Jul 05 19:20:20 BST 2013, Mike Bostock, Mike Bostock, 6, 6, 12, 0, 13
Fri Jul 05 19:19:53 BST 2013, Mike Bostock, Mike Bostock, 138, 64, 202, 0, 43
Fri Jul 05 19:19:30 BST 2013, Mike Bostock, Mike Bostock, 12, 13, 25, 0, 47
Fri Jul 05 19:19:04 BST 2013, Mike Bostock, Mike Bostock, 262, 171, 433, 0, 43
Wed Jul 03 17:52:28 BST 2013, Mike Bostock, Mike Bostock, 261, 170, 431, 0, 508
Fri Jul 05 18:45:24 BST 2013, Mike Bostock, Mike Bostock, 86, 17, 103, 0, 47
Fri Jul 05 18:44:58 BST 2013, Mike Bostock, Mike Bostock, 13, 23, 36, 0, 42
Fri Jul 05 18:32:37 BST 2013, Mike Bostock, Mike Bostock, 51, 12, 63, 0, 190
Fri Jul 05 18:00:29 BST 2013, Mike Bostock, Mike Bostock, 91, 56, 147, 0, 729
Thu Jul 04 18:35:30 BST 2013, Mike Bostock, Mike Bostock, 12, 13, 25, 0, 46
Thu Jul 04 18:14:18 BST 2013, Mike Bostock, Mike Bostock, 12, 14, 26, 0, 36
Fri Jun 28 23:15:09 BST 2013, Mike Bostock, Mike Bostock, 51, 23, 74, 0, 383
Wed Jul 03 18:08:27 BST 2013, Mike Bostock, Mike Bostock, 455, 355, 810, 0, 85
Wed Jul 03 18:05:14 BST 2013, Mike Bostock, Mike Bostock, 2, 2, 4, 0, 29
Tue Jul 02 01:49:18 BST 2013, Mike Bostock, Mike Bostock, 11, 21, 32, 0, 462
Wed Jul 03 05:09:53 BST 2013, Mike Bostock, Mike Bostock, 10, 4, 14, 0, 92
Tue Jul 02 18:28:23 BST 2013, Mike Bostock, Mike Bostock, 20, 2, 22, 0, 43
Tue Jul 02 18:23:10 BST 2013, Mike Bostock, Mike Bostock, 3, 7, 10, 0, 14
Tue Jul 02 18:22:18 BST 2013, Mike Bostock, Mike Bostock, 22, 0, 22, 0, 26
Tue Jul 02 17:07:38 BST 2013, Mike Bostock, Mike Bostock, 52, 25, 77, 0, 438
Mon Jul 01 19:10:05 BST 2013, Mike Bostock, Mike Bostock, 437, 349, 786, 0, 20
Mon Jul 01 19:08:34 BST 2013, Mike Bostock, Mike Bostock, 36, 9, 45, 0, 50
Mon Jul 01 19:08:08 BST 2013, Mike Bostock, Mike Bostock, 54, 66, 120, 0, 51
Mon Jul 01 19:07:45 BST 2013, Mike Bostock, Mike Bostock, 224, 139, 363, 0, 42
Mon Jul 01 19:07:10 BST 2013, Mike Bostock, Mike Bostock, 130, 142, 272, 0, 51
Mon Jul 01 19:05:15 BST 2013, Mike Bostock, Mike Bostock, 18, 6, 24, 0, 36
Mon Jul 01 16:48:49 BST 2013, Mike Bostock, Mike Bostock, 1, 4, 5, 0, 23
Sun Jun 30 18:50:57 BST 2013, Mike Bostock, Mike Bostock, 6, 0, 6, 0, 26
Sun Jun 30 18:33:17 BST 2013, Mike Bostock, Mike Bostock, 48, 66, 114, 0, 1021
Sun Jun 30 18:02:58 BST 2013, Mike Bostock, Mike Bostock, 36, 9, 45, 0, 46
Sun Jun 30 17:53:33 BST 2013, Mike Bostock, Mike Bostock, 22, 8, 30, 0, 28
Sun Jun 30 01:47:17 BST 2013, Mike Bostock, Mike Bostock, 2, 1, 3, 0, 18
Sat Jun 29 18:26:38 BST 2013, Mike Bostock, Mike Bostock, 8, 8, 16, 0, 32
Sat Jun 29 17:24:41 BST 2013, Mike Bostock, Mike Bostock, 8, 8, 16, 0, 33
Sat Jun 29 17:18:37 BST 2013, Mike Bostock, Mike Bostock, 44, 0, 44, 0, 68
Sat Jun 29 17:03:09 BST 2013, Mike Bostock, Mike Bostock, 2, 0, 2, 0, 39
Sat Jun 29 07:01:06 BST 2013, Jared Forsyth, Jared Forsyth, 37, 3, 40, 0, 20
Sat Jun 29 05:58:25 BST 2013, Jared Forsyth, Jared Forsyth, 10, 0, 10, 0, 27
Fri Jun 28 23:35:19 BST 2013, Mike Bostock, Mike Bostock, 122, 134, 256, 0, 600
Fri Jun 28 16:29:16 BST 2013, Mike Bostock, Mike Bostock, 168, 145, 313, 0, 398
Thu Jun 27 21:29:38 BST 2013, Mike Bostock, Mike Bostock, 67, 11, 78, 0, 194
Thu Jun 27 21:28:52 BST 2013, Mike Bostock, Mike Bostock, 1, 1, 2, 0, 30
Thu Jun 27 20:58:15 BST 2013, Mike Bostock, Mike Bostock, 13, 7, 20, 0, 39
Thu Jun 27 19:32:08 BST 2013, Mike Bostock, Mike Bostock, 46, 20, 66, 5, 38
Thu Jun 27 17:47:33 BST 2013, Mike Bostock, Mike Bostock, 0, 0, 0, 0, 27
Thu Jun 27 17:46:35 BST 2013, Mike Bostock, Mike Bostock, 14, 25, 39, 0, 33
Wed Jun 26 16:04:35 BST 2013, Mike Bostock, Mike Bostock, 62, 0, 62, 0, 83
Wed Jun 26 08:53:26 BST 2013, Jason Davies, Jason Davies, 13, 6, 19, 0, 219
Wed Jun 26 01:07:20 BST 2013, Mike Bostock, Mike Bostock, 5, 5, 10, 0, 15
Wed Jun 26 01:06:36 BST 2013, Mike Bostock, Mike Bostock, 270, 288, 558, 0, 39
Wed Jun 26 01:01:21 BST 2013, Mike Bostock, Mike Bostock, 93, 6, 99, 0, 45
Wed Jun 26 00:53:02 BST 2013, Mike Bostock, Mike Bostock, 27, 30, 57, 0, 24
Wed Jun 26 00:46:13 BST 2013, Mike Bostock, Mike Bostock, 64, 86, 150, 0, 405
Tue Jun 25 16:34:30 BST 2013, Mike Bostock, Mike Bostock, 1, 1, 2, 0, 16
Tue Jun 25 15:59:21 BST 2013, Mike Bostock, Mike Bostock, 27, 45, 72, 0, 101
Tue Jun 25 10:00:37 BST 2013, Jason Davies, Jason Davies, 12, 10, 22, 0, 422
Mon Jun 24 23:37:28 BST 2013, Erik Cunningham, Erik Cunningham, 0, 2, 2, 0, 27
Mon Jun 24 23:35:06 BST 2013, Erik Cunningham, Erik Cunningham, 46, 1, 47, 0, 39
Mon Jun 24 22:28:54 BST 2013, Erik Cunningham, Erik Cunningham, 19, 0, 19, 0, 27
Fri Jun 21 16:51:53 BST 2013, Mike Bostock, Mike Bostock, 7, 7, 14, 0, 13
Fri Jun 21 16:44:08 BST 2013, Mike Bostock, Mike Bostock, 3, 3, 6, 0, 36
Fri Jun 21 16:24:29 BST 2013, Mike Bostock, Mike Bostock, 5, 5, 10, 0, 335
Thu Jun 20 16:52:00 BST 2013, Mike Bostock, Mike Bostock, 86, 1, 87, 0, 37
Thu Jun 20 03:03:29 BST 2013, adnan, adnan, 7, 5, 12, 0, 19
Wed Jun 19 18:55:00 BST 2013, Mike Bostock, Mike Bostock, 85, 38, 123, 0, 20
Wed Jun 19 18:53:51 BST 2013, Mike Bostock, Mike Bostock, 25, 6, 31, 0, 30
Wed Jun 19 18:53:03 BST 2013, Mike Bostock, Mike Bostock, 8, 5, 13, 0, 37
Wed Jun 19 18:52:10 BST 2013, Mike Bostock, Mike Bostock, 7, 7, 14, 0, 55
Wed Jun 19 18:50:26 BST 2013, Mike Bostock, Mike Bostock, 5, 5, 10, 0, 28
Wed Jun 19 00:16:47 BST 2013, Mike Bostock, Mike Bostock, 8, 13, 21, 0, 592
Tue Jun 18 23:59:16 BST 2013, Mike Bostock, Mike Bostock, 11, 9, 20, 0, 169
Tue Jun 18 18:33:01 BST 2013, Mike Bostock, Mike Bostock, 13, 13, 26, 0, 17
Tue Jun 18 18:20:11 BST 2013, Mike Bostock, Mike Bostock, 45, 17, 62, 0, 1083
Fri Jun 14 19:37:18 BST 2013, Mike Bostock, Mike Bostock, 3, 3, 6, 0, 41
Fri Jun 14 10:10:00 BST 2013, Jason Davies, Jason Davies, 8, 5, 13, 0, 150
Fri Jun 07 21:54:11 BST 2013, Jason Davies, Jason Davies, 25, 6, 31, 0, 38
Thu Jun 13 23:47:51 BST 2013, Mike Bostock, Mike Bostock, 2850, 1380, 4230, 0, 18
Thu Jun 13 23:23:39 BST 2013, Mike Bostock, Mike Bostock, 16, 0, 16, 0, 34
Thu Jun 13 23:19:51 BST 2013, Mike Bostock, Mike Bostock, 17, 13, 30, 0, 14
Thu Jun 13 22:00:03 BST 2013, Mike Bostock, Mike Bostock, 87, 77, 164, 0, 38
Thu Jun 13 00:40:19 BST 2013, Mike Bostock, Mike Bostock, 41, 37, 78, 0, 298
Thu Jun 13 00:07:42 BST 2013, Mike Bostock, Mike Bostock, 77, 34, 111, 0, 35
Wed Jun 12 21:19:20 BST 2013, Mike Bostock, Mike Bostock, 45, 30, 75, 0, 585
Fri May 31 23:13:50 BST 2013, Jason Davies, Jason Davies, 77, 34, 111, 5, 700
Tue Jun 11 23:59:55 BST 2013, Mike Bostock, Mike Bostock, 18, 18, 36, 0, 117
Tue Jun 11 23:33:43 BST 2013, Mike Bostock, Mike Bostock, 7, 7, 14, 0, 39
Tue Jun 11 20:22:18 BST 2013, Mike Bostock, Mike Bostock, 10, 13, 23, 0, 18
Tue Jun 11 20:19:20 BST 2013, Mike Bostock, Mike Bostock, 43, 50, 93, 0, 28
Tue Jun 11 10:18:25 BST 2013, Jason Davies, Jason Davies, 124, 22, 146, 0, 186
Sat Jun 08 20:53:37 BST 2013, Jason Davies, Jason Davies, 0, 2, 2, 0, 49
Mon Aug 13 11:51:29 BST 2012, Jason Davies, Jason Davies, 167, 42, 209, 0, 99
Sat Jun 08 18:57:22 BST 2013, Jason Davies, Jason Davies, 524, 111, 635, 0, 163
Sat Jun 08 17:12:35 BST 2013, Jason Davies, Jason Davies, 34, 32, 66, 0, 134
Sat Jun 08 16:08:25 BST 2013, Jason Davies, Jason Davies, 1, 1, 2, 0, 12
Tue Jun 04 19:38:37 BST 2013, Mike Bostock, Mike Bostock, 3, 3, 6, 0, 95
Tue Jun 04 19:33:15 BST 2013, Jason Davies, Jason Davies, 3, 3, 6, 0, 50
Tue Jun 04 02:13:28 BST 2013, Mike Bostock, Mike Bostock, 165, 0, 165, 0, 32
Mon Jun 03 21:28:46 BST 2013, Mike Bostock, Mike Bostock, 3, 11, 14, 0, 250
Mon Jun 03 21:23:41 BST 2013, Mike Bostock, Mike Bostock, 1, 1, 2, 0, 27
Tue Jan 15 22:50:42 GMT 2013, Jason Davies, Jason Davies, 291, 191, 482, 0, 971
Sat Jun 01 18:11:46 BST 2013, Mike Bostock, Mike Bostock, 9, 7, 16, 0, 45
Sat Jun 01 17:44:04 BST 2013, Mike Bostock, Mike Bostock, 18, 8, 26, 3, 142
Thu May 30 23:14:12 BST 2013, Mike Bostock, Mike Bostock, 25, 3, 28, 0, 56
Thu May 30 22:48:08 BST 2013, Mike Bostock, Mike Bostock, 17, 6, 23, 0, 51
Thu May 30 22:23:50 BST 2013, Mike Bostock, Mike Bostock, 55, 25, 80, 0, 67
Thu May 30 20:26:24 BST 2013, Mike Bostock, Mike Bostock, 72, 3, 75, 0, 32
Thu May 30 20:19:52 BST 2013, Mike Bostock, Mike Bostock, 56, 18, 74, 0, 33
Thu May 30 20:18:38 BST 2013, Mike Bostock, Mike Bostock, 13, 13, 26, 0, 27
Thu May 30 20:15:22 BST 2013, Mike Bostock, Mike Bostock, 44, 7, 51, 0, 77
Thu May 30 20:04:35 BST 2013, Mike Bostock, Mike Bostock, 21, 4, 25, 0, 48
Thu May 30 19:48:44 BST 2013, Mike Bostock, Mike Bostock, 98, 76, 174, 0, 36
Thu May 30 19:45:08 BST 2013, Mike Bostock, Mike Bostock, 29, 5, 34, 0, 64
Thu May 30 19:38:07 BST 2013, Mike Bostock, Mike Bostock, 47, 5, 52, 0, 56
Thu May 30 19:34:47 BST 2013, Mike Bostock, Mike Bostock, 69, 28, 97, 0, 36
Thu May 30 19:30:42 BST 2013, Mike Bostock, Mike Bostock, 23, 16, 39, 0, 39
Thu May 30 19:29:47 BST 2013, Mike Bostock, Mike Bostock, 3, 1, 4, 0, 55
Thu May 30 19:29:09 BST 2013, Mike Bostock, Mike Bostock, 15, 5, 20, 0, 43
Thu May 30 19:27:41 BST 2013, Mike Bostock, Mike Bostock, 3, 3, 6, 0, 35
Thu May 30 19:26:43 BST 2013, Mike Bostock, Mike Bostock, 72, 34, 106, 0, 35
Thu May 30 19:26:14 BST 2013, Mike Bostock, Mike Bostock, 10, 8, 18, 0, 47
Thu May 30 19:25:46 BST 2013, Mike Bostock, Mike Bostock, 1, 1, 2, 0, 30
Thu May 30 19:25:12 BST 2013, Mike Bostock, Mike Bostock, 36, 23, 59, 0, 42
Thu May 30 19:24:29 BST 2013, Mike Bostock, Mike Bostock, 774, 718, 1492, 0, 36
Wed Jan 30 19:15:37 GMT 2013, Mike Bostock, Mike Bostock, 95, 74, 169, 0, 104
Thu May 02 15:13:41 BST 2013, Jason Davies, Mike Bostock, 46, 26, 72, 0, 47
Fri Dec 14 15:21:51 GMT 2012, Jason Davies, Mike Bostock, 30, 9, 39, 0, 788
Thu May 30 18:03:57 BST 2013, Mike Bostock, Mike Bostock, 1, 3, 4, 0, 47
Wed May 29 22:57:30 BST 2013, Mike Bostock, Mike Bostock, 14, 10, 24, 0, 29
Wed May 29 22:37:46 BST 2013, Mike Bostock, Mike Bostock, 44, 56, 100, 0, 38
Wed May 29 21:13:53 BST 2013, Jason Davies, Jason Davies, 11, 0, 11, 0, 41
Wed May 29 19:48:42 BST 2013, Jason Davies, Jason Davies, 767, 714, 1481, 0, 352
Wed May 29 18:55:20 BST 2013, Mike Bostock, Mike Bostock, 8, 11, 19, 0, 17
Wed May 29 18:52:21 BST 2013, Mike Bostock, Mike Bostock, 17, 21, 38, 0, 21
Wed May 29 18:49:37 BST 2013, Mike Bostock, Mike Bostock, 22, 2, 24, 0, 82
Wed May 29 16:21:26 BST 2013, Jason Davies, Jason Davies, 6, 6, 12, 0, 71
Wed May 29 01:08:15 BST 2013, Mike Bostock, Mike Bostock, 12, 10, 22, 0, 50
Wed May 29 00:48:03 BST 2013, Jason Davies, Jason Davies, 74, 36, 110, 0, 297
Wed May 29 00:43:21 BST 2013, Mike Bostock, Mike Bostock, 3, 3, 6, 0, 247
Wed May 29 00:23:53 BST 2013, Ryan Alexander, Ryan Alexander, 17, 0, 17, 0, 48
Tue May 28 23:59:53 BST 2013, Mike Bostock, Mike Bostock, 202, 161, 363, 0, 21
Tue May 28 23:56:31 BST 2013, Mike Bostock, Mike Bostock, 38, 39, 77, 0, 49
Tue May 28 23:55:57 BST 2013, Mike Bostock, Mike Bostock, 42, 10, 52, 0, 43
Tue May 28 23:55:13 BST 2013, Mike Bostock, Mike Bostock, 42, 8, 50, 0, 42
Tue May 28 23:51:36 BST 2013, Mike Bostock, Mike Bostock, 30, 83, 113, 0, 17
Tue May 28 23:44:38 BST 2013, Mike Bostock, Mike Bostock, 36, 13, 49, 0, 20
Tue May 28 23:44:08 BST 2013, Mike Bostock, Mike Bostock, 36, 7, 43, 0, 97
Mon May 20 20:21:59 BST 2013, Mike Bostock, Mike Bostock, 14, 4, 18, 0, 204
Tue May 28 22:17:20 BST 2013, Mike Bostock, Mike Bostock, 8, 8, 16, 0, 23
Tue May 28 22:15:15 BST 2013, Mike Bostock, Mike Bostock, 5, 6, 11, 0, 11
Tue May 28 22:10:17 BST 2013, Mike Bostock, Mike Bostock, 21, 35, 56, 0, 523
Tue May 28 21:58:39 BST 2013, Mike Bostock, Mike Bostock, 3, 3, 6, 0, 19
Tue May 28 21:57:26 BST 2013, Mike Bostock, Mike Bostock, 0, 18, 18, 0, 41
Tue May 28 21:50:41 BST 2013, Mike Bostock, Mike Bostock, 41, 58, 99, 0, 419
Tue May 28 21:50:04 BST 2013, Mike Bostock, Mike Bostock, 23, 23, 46, 0, 45
Tue May 28 21:29:21 BST 2013, Mike Bostock, Mike Bostock, 55, 29, 84, 0, 300
Tue May 28 09:10:50 BST 2013, Ryan Alexander, Ryan Alexander, 2, 2, 4, 0, 25
Tue May 28 09:04:26 BST 2013, Ryan Alexander, Ryan Alexander, 5, 2, 7, 0, 62
Sun May 26 05:54:51 BST 2013, Freeyorp, Freeyorp, 28, 5, 33, 0, 781
Sat May 25 01:30:13 BST 2013, Carlos Rendon, Carlos Rendon, 30, 4, 34, 0, 48
Sat May 25 01:08:39 BST 2013, Carlos Rendon, Carlos Rendon, 2, 3, 5, 0, 15
Sat May 25 00:35:49 BST 2013, Carlos Rendon, crendon, 6, 7, 13, 0, 29
Fri May 24 20:37:58 BST 2013, Jason Davies, Jason Davies, 35, 1, 36, 0, 53
Fri May 24 18:59:50 BST 2013, Jason Davies, Jason Davies, 7, 7, 14, 0, 45
Thu May 23 00:59:45 BST 2013, Mike Bostock, Mike Bostock, 42, 10, 52, 2, 343
Wed May 22 03:36:27 BST 2013, Carlos Rendon, Carlos Rendon, 4, 4, 8, 0, 31
Wed May 22 02:58:52 BST 2013, Carlos Rendon, Carlos Rendon, 1, 21, 22, 0, 21
Tue May 21 18:01:02 BST 2013, Carlos Rendon, Carlos Rendon, 31, 7, 38, 0, 25
Tue May 21 00:08:32 BST 2013, Carlos Rendon, Carlos Rendon, 6, 5, 11, 0, 207
Mon May 20 21:36:44 BST 2013, Mike Bostock, Mike Bostock, 25, 16, 41, 0, 219
Mon May 20 18:40:20 BST 2013, Mike Bostock, Mike Bostock, 10, 19, 29, 0, 34
Mon May 20 18:31:07 BST 2013, Mike Bostock, Mike Bostock, 255, 208, 463, 0, 20
Mon May 20 18:29:57 BST 2013, Mike Bostock, Mike Bostock, 12, 12, 24, 0, 40
Mon May 20 18:26:27 BST 2013, Mike Bostock, Mike Bostock, 15, 15, 30, 0, 170
Mon May 20 18:03:10 BST 2013, Mike Bostock, Mike Bostock, 34, 25, 59, 0, 24
Mon May 20 17:45:41 BST 2013, Mike Bostock, Mike Bostock, 38, 20, 58, 0, 34
Mon May 20 17:39:50 BST 2013, Mike Bostock, Mike Bostock, 1, 0, 1, 0, 19
Mon May 20 13:30:01 BST 2013, Jason Davies, Jason Davies, 4, 9, 13, 0, 15
Mon May 20 13:23:59 BST 2013, Jason Davies, Jason Davies, 16, 14, 30, 0, 45
Mon May 20 13:15:25 BST 2013, Jason Davies, Jason Davies, 17, 17, 34, 0, 27
Mon May 20 13:05:32 BST 2013, Jason Davies, Jason Davies, 5, 5, 10, 0, 242
Mon May 20 08:46:13 BST 2013, Jason Davies, Jason Davies, 2, 1, 3, 0, 255
Mon May 20 06:02:51 BST 2013, Mike Bostock, Mike Bostock, 18, 3, 21, 0, 31
Mon May 20 05:59:38 BST 2013, Mike Bostock, Mike Bostock, 79, 62, 141, 0, 33
Mon May 20 00:28:29 BST 2013, Mike Bostock, Mike Bostock, 5, 5, 10, 0, 20
Mon May 20 00:13:32 BST 2013, Mike Bostock, Mike Bostock, 22, 18, 40, 0, 108
Sun May 19 21:04:38 BST 2013, Mike Bostock, Mike Bostock, 5, 8, 13, 0, 17
Sun May 19 20:58:50 BST 2013, Mike Bostock, Mike Bostock, 5, 5, 10, 0, 37
Sun May 19 19:46:10 BST 2013, Mike Bostock, Mike Bostock, 24, 24, 48, 0, 34
Sun May 19 19:38:22 BST 2013, Mike Bostock, Mike Bostock, 108, 120, 228, 0, 560
Fri May 17 04:39:20 BST 2013, shilad, shilad, 1, 0, 1, 0, 57
Thu May 16 00:11:34 BST 2013, Mike Bostock, Mike Bostock, 5, 5, 10, 0, 13
Thu May 16 00:10:44 BST 2013, Mike Bostock, Mike Bostock, 40, 32, 72, 0, 64
Thu May 16 00:10:30 BST 2013, Mike Bostock, Mike Bostock, 85, 63, 148, 0, 65
Thu May 16 00:09:58 BST 2013, Mike Bostock, Mike Bostock, 10, 6, 16, 0, 63
Thu May 16 00:09:31 BST 2013, Mike Bostock, Mike Bostock, 51, 3, 54, 0, 58
Thu May 16 00:09:02 BST 2013, Mike Bostock, Mike Bostock, 486, 111, 597, 0, 59
Thu May 16 00:05:25 BST 2013, Mike Bostock, Mike Bostock, 2, 2, 4, 0, 94
Wed May 15 23:48:13 BST 2013, Mike Bostock, Mike Bostock, 34, 28, 62, 0, 490
Mon May 13 23:11:59 BST 2013, Mike Bostock, Mike Bostock, 84, 62, 146, 0, 328
Wed May 08 11:39:28 BST 2013, Jason Davies, Jason Davies, 2, 2, 4, 0, 333
Wed May 08 10:44:22 BST 2013, Jason Davies, Jason Davies, 2, 4, 6, 0, 118
Sun May 05 00:48:59 BST 2013, Jason Davies, Jason Davies, 18, 13, 31, 0, 285
Thu Mar 21 21:47:12 GMT 2013, Jason Davies, Jason Davies, 486, 111, 597, 0, 1387
Sat May 04 12:31:43 BST 2013, Jason Davies, Jason Davies, 51, 3, 54, 0, 204
Wed May 01 18:23:56 BST 2013, Jason Davies, Jason Davies, 9, 5, 14, 0, 575
Wed May 01 00:09:40 BST 2013, Mike Bostock, Mike Bostock, 14, 4, 18, 0, 49
Tue Apr 30 23:56:30 BST 2013, Mike Bostock, Mike Bostock, 321, 166, 487, 0, 20
Tue Apr 30 23:55:25 BST 2013, Mike Bostock, Mike Bostock, 171, 32, 203, 0, 35
Tue Apr 30 23:54:43 BST 2013, Mike Bostock, Mike Bostock, 37, 49, 86, 0, 37
Tue Apr 30 23:54:06 BST 2013, Mike Bostock, Mike Bostock, 69, 33, 102, 0, 36
Tue Apr 30 23:53:31 BST 2013, Mike Bostock, Mike Bostock, 9, 20, 29, 0, 30
Tue Apr 30 23:52:32 BST 2013, Mike Bostock, Mike Bostock, 2, 2, 4, 0, 31
Fri Apr 19 22:06:41 BST 2013, Mike Bostock, Mike Bostock, 41, 38, 79, 0, 35
Tue Apr 30 23:30:56 BST 2013, Mike Bostock, Mike Bostock, 11, 7, 18, 0, 34
Tue Apr 30 23:17:22 BST 2013, Mike Bostock, Mike Bostock, 27, 43, 70, 0, 11
Tue Apr 30 22:46:32 BST 2013, Mike Bostock, Mike Bostock, 55, 29, 84, 0, 322
Tue Apr 30 22:12:02 BST 2013, Mike Bostock, Mike Bostock, 17, 7, 24, 0, 60
Thu Apr 25 20:33:06 BST 2013, Mike Bostock, Mike Bostock, 1, 1, 2, 0, 12
Thu Apr 25 19:48:02 BST 2013, Mike Bostock, Mike Bostock, 17, 71, 88, 3, 38
Sat Apr 20 20:50:36 BST 2013, Mike Bostock, Mike Bostock, 56, 18, 74, 0, 40
Fri Apr 19 22:57:41 BST 2013, Mike Bostock, Mike Bostock, 22, 16, 38, 0, 33
Fri Apr 19 18:36:10 BST 2013, Mike Bostock, Mike Bostock, 9, 20, 29, 0, 22
Fri Apr 19 18:20:21 BST 2013, Mike Bostock, Mike Bostock, 171, 32, 203, 0, 674
Thu Apr 18 04:28:07 BST 2013, Scott Cheng, Scott Cheng, 12, 0, 12, 0, 95
Thu Apr 18 04:12:19 BST 2013, Scott Cheng, Scott Cheng, 1, 0, 1, 0, 67
Wed Apr 17 17:56:37 BST 2013, Scott Cheng, Scott Cheng, 5, 0, 5, 0, 64
Wed Apr 17 17:55:10 BST 2013, Scott Cheng, Scott Cheng, 3, 8, 11, 0, 56
Wed Apr 17 15:47:30 BST 2013, Scott Cheng, Scott Cheng, 7, 0, 7, 0, 40
Wed Apr 17 15:34:19 BST 2013, Scott Cheng, Scott Cheng, 7, 6, 13, 0, 66
Wed Apr 17 12:18:18 BST 2013, Scott Cheng, Scott Cheng, 2, 2, 4, 0, 47
Mon Apr 15 15:52:57 BST 2013, Scott Cheng, Scott Cheng, 11, 1, 12, 0, 25
Thu Apr 11 18:20:44 BST 2013, Jason Davies, Jason Davies, 1, 1, 2, 0, 29
Thu Apr 11 17:21:37 BST 2013, Mike Bostock, Mike Bostock, 3, 3, 6, 0, 62
Thu Apr 11 15:26:06 BST 2013, Chia-liang Kao, Chia-liang Kao, 1, 1, 2, 0, 24
Thu Apr 11 15:20:30 BST 2013, Chia-liang Kao, Chia-liang Kao, 2, 2, 4, 0, 26
Sun Apr 07 03:29:44 BST 2013, Mike Bostock, Mike Bostock, 243, 144, 387, 0, 20
Sun Apr 07 03:27:55 BST 2013, Mike Bostock, Mike Bostock, 22, 30, 52, 0, 35
Sun Apr 07 03:21:36 BST 2013, Mike Bostock, Mike Bostock, 36, 28, 64, 0, 73
Sun Apr 07 03:16:38 BST 2013, Mike Bostock, Mike Bostock, 12, 6, 18, 0, 43
Sun Apr 07 03:16:12 BST 2013, Mike Bostock, Mike Bostock, 203, 110, 313, 0, 41
Fri Apr 05 04:49:57 BST 2013, Mike Bostock, Mike Bostock, 12, 6, 18, 0, 23
Wed Apr 03 18:54:52 BST 2013, Mike Bostock, Mike Bostock, 7, 1, 8, 0, 29
Wed Apr 03 18:54:21 BST 2013, Mike Bostock, Mike Bostock, 7, 1, 8, 0, 73
Wed Apr 03 18:46:15 BST 2013, Mike Bostock, Mike Bostock, 7, 5, 12, 0, 31
Wed Apr 03 18:44:13 BST 2013, Mike Bostock, Mike Bostock, 6, 2, 8, 0, 97
Wed Apr 03 15:29:14 BST 2013, Dan Milon, Dan Milon, 6, 2, 8, 0, 21
Tue Apr 02 17:02:09 BST 2013, Mike Bostock, Mike Bostock, 12, 0, 12, 0, 40
Tue Apr 02 21:56:07 BST 2013, Mike Bostock, Mike Bostock, 1, 0, 1, 0, 68
Tue Apr 02 18:21:29 BST 2013, JD Isaacks, JD Isaacks, 4, 13, 17, 0, 56
Tue Apr 02 17:16:50 BST 2013, JD Isaacks, JD Isaacks, 28, 25, 53, 0, 48
Tue Apr 02 17:00:45 BST 2013, John Firebaugh, John Firebaugh, 1, 0, 1, 0, 18
Tue Apr 02 15:58:44 BST 2013, JD Isaacks, JD Isaacks, 47, 6, 53, 0, 65
Sun Mar 31 17:48:10 BST 2013, Mike Bostock, Mike Bostock, 53, 53, 106, 0, 30
Sun Mar 31 17:46:07 BST 2013, Mike Bostock, Mike Bostock, 150, 57, 207, 0, 122
Sat Mar 30 00:23:57 GMT 2013, Dan Tillberg, Dan Tillberg, 18, 13, 31, 0, 130
Wed Mar 27 06:45:50 GMT 2013, Lee Leathers, Lee Leathers, 7, 1, 8, 0, 44
Tue Mar 26 22:11:06 GMT 2013, Adam Sunderland, Adam Sunderland, 4, 4, 8, 0, 48
Tue Mar 26 20:01:05 GMT 2013, Adam Sunderland, Adam Sunderland, 3, 3, 6, 0, 31
Tue Mar 26 19:50:54 GMT 2013, Adam Sunderland, Adam Sunderland, 17, 0, 17, 0, 42
Mon Mar 25 10:29:37 GMT 2013, Jason Davies, Jason Davies, 3, 0, 3, 0, 159
Mon Mar 25 08:51:16 GMT 2013, Jason Davies, Jason Davies, 21, 0, 21, 0, 50
Sun Mar 24 23:51:00 GMT 2013, Mike Bostock, Mike Bostock, 10, 10, 20, 0, 32
Sun Mar 24 23:44:28 GMT 2013, Mike Bostock, Mike Bostock, 5, 5, 10, 0, 42
Fri Mar 22 22:38:56 GMT 2013, Mike Bostock, Mike Bostock, 71, 13, 84, 0, 353
Thu Mar 21 23:59:50 GMT 2013, Jason Davies, Jason Davies, 30, 0, 30, 0, 37
Thu Mar 21 23:52:26 GMT 2013, Mike Bostock, Mike Bostock, 8, 6, 14, 0, 31
Thu Mar 21 23:46:26 GMT 2013, Mike Bostock, Mike Bostock, 15, 20, 35, 0, 26
Thu Mar 21 23:41:40 GMT 2013, Jason Davies, Jason Davies, 11, 16, 27, 0, 47
Thu Mar 21 22:54:53 GMT 2013, Mike Bostock, Mike Bostock, 17609, 14616, 32225, 0, 20
Thu Mar 21 22:24:53 GMT 2013, Jason Davies, Jason Davies, 0, 3, 3, 0, 30
Thu Mar 21 22:01:51 GMT 2013, Jason Davies, Jason Davies, 19, 19, 38, 0, 23
Thu Mar 21 21:49:19 GMT 2013, Jason Davies, Jason Davies, 4, 4, 8, 0, 29
Thu Mar 21 12:56:54 GMT 2013, Jason Davies, Jason Davies, 11, 11, 22, 0, 31
Thu Mar 21 04:54:33 GMT 2013, Mike Bostock, Mike Bostock, 15, 29, 44, 0, 41
Thu Mar 21 04:34:12 GMT 2013, Mike Bostock, Mike Bostock, 435, 3, 438, 0, 64
Wed Mar 20 09:12:09 GMT 2013, Jason Davies, Jason Davies, 2, 2, 4, 0, 21
Tue Mar 19 17:19:21 GMT 2013, Jason Davies, Jason Davies, 305, 199, 504, 0, 22
Tue Mar 19 16:43:05 GMT 2013, Jason Davies, Jason Davies, 4, 4, 8, 0, 9
Tue Mar 19 16:39:39 GMT 2013, Jason Davies, Jason Davies, 60, 46, 106, 0, 41
Tue Mar 19 16:30:45 GMT 2013, Jason Davies, Jason Davies, 14, 15, 29, 0, 9
Tue Mar 19 16:25:28 GMT 2013, Jason Davies, Jason Davies, 40, 26, 66, 0, 42
Tue Mar 19 16:14:43 GMT 2013, Jason Davies, Jason Davies, 8, 6, 14, 0, 37
Tue Mar 19 16:13:11 GMT 2013, Jason Davies, Jason Davies, 33, 32, 65, 0, 39
Tue Mar 19 16:02:09 GMT 2013, Jason Davies, Jason Davies, 24, 19, 43, 0, 42
Tue Mar 19 15:56:24 GMT 2013, Jason Davies, Jason Davies, 48, 46, 94, 0, 76
Tue Mar 19 15:54:57 GMT 2013, Jason Davies, Jason Davies, 1, 2, 3, 1, 40
Tue Mar 19 15:53:53 GMT 2013, Jason Davies, Jason Davies, 3, 3, 6, 0, 51
Tue Mar 19 15:50:07 GMT 2013, Jason Davies, Jason Davies, 3, 1, 4, 0, 41
Tue Mar 19 15:44:00 GMT 2013, Jason Davies, Jason Davies, 22, 20, 42, 0, 29
Tue Mar 19 15:30:37 GMT 2013, Jason Davies, Jason Davies, 9, 7, 16, 0, 46
Tue Mar 19 15:26:02 GMT 2013, Jason Davies, Jason Davies, 5, 3, 8, 0, 46
Tue Mar 19 15:21:06 GMT 2013, Jason Davies, Jason Davies, 2, 2, 4, 0, 39
Tue Mar 19 15:19:29 GMT 2013, Jason Davies, Jason Davies, 6, 6, 12, 0, 42
Tue Mar 19 15:17:00 GMT 2013, Jason Davies, Jason Davies, 37, 37, 74, 0, 78
Tue Mar 19 15:10:29 GMT 2013, Jason Davies, Jason Davies, 19, 7, 26, 0, 44
Tue Mar 19 10:53:08 GMT 2013, Jason Davies, Jason Davies, 282, 182, 464, 0, 38
Tue Mar 19 10:33:56 GMT 2013, Jason Davies, Jason Davies, 2546, 2560, 5106, 0, 37
Tue Mar 19 10:54:40 GMT 2013, Jason Davies, Jason Davies, 4, 4, 8, 0, 24
Sat Mar 16 22:23:26 GMT 2013, Ilya Boyandin, Ilya Boyandin, 3, 3, 6, 0, 85
Sat Mar 16 19:44:34 GMT 2013, Mike Bostock, Mike Bostock, 4, 1, 5, 0, 20
Sat Mar 16 15:49:48 GMT 2013, Jason Davies, Jason Davies, 8, 5, 13, 4, 267
Sat Mar 16 00:18:26 GMT 2013, Mike Bostock, Mike Bostock, 10, 8, 18, 0, 11
Sat Mar 16 00:15:20 GMT 2013, Mike Bostock, Mike Bostock, 36, 18, 54, 0, 205
Sat Mar 16 00:15:07 GMT 2013, Mike Bostock, Mike Bostock, 3, 1, 4, 0, 18
Fri Mar 15 23:30:20 GMT 2013, Jason Davies, Jason Davies, 99, 19, 118, 0, 40
Fri Mar 15 17:09:55 GMT 2013, Mike Bostock, Mike Bostock, 58, 56, 114, 0, 21
Fri Mar 15 16:55:53 GMT 2013, Jason Davies, Jason Davies, 60, 0, 60, 0, 44
Fri Mar 15 15:27:24 GMT 2013, Mike Bostock, Mike Bostock, 10, 12, 22, 0, 26
Fri Mar 15 15:01:47 GMT 2013, Jason Davies, Jason Davies, 4, 4, 8, 1, 216
Thu Mar 14 22:43:18 GMT 2013, Jason Davies, Jason Davies, 3, 3, 6, 0, 22
Thu Mar 14 22:30:24 GMT 2013, Mike Bostock, Mike Bostock, 5, 5, 10, 0, 20
Thu Mar 14 22:14:12 GMT 2013, Mike Bostock, Mike Bostock, 193, 192, 385, 0, 42
Thu Mar 14 21:49:08 GMT 2013, Jason Davies, Jason Davies, 5, 5, 10, 0, 22
Thu Mar 14 11:44:45 GMT 2013, Jason Davies, Jason Davies, 17, 5, 22, 0, 90
Thu Mar 14 21:32:13 GMT 2013, Mike Bostock, Mike Bostock, 3, 3, 6, 0, 29
Thu Mar 14 21:28:25 GMT 2013, Mike Bostock, Mike Bostock, 2, 0, 2, 0, 30
Thu Mar 14 21:12:47 GMT 2013, Mike Bostock, Mike Bostock, 125, 125, 250, 0, 24
Thu Mar 14 21:11:40 GMT 2013, Mike Bostock, Mike Bostock, 22, 14, 36, 0, 18
Thu Mar 14 20:59:18 GMT 2013, Mike Bostock, Mike Bostock, 114, 132, 246, 0, 40
Thu Mar 14 20:29:24 GMT 2013, Mike Bostock, Mike Bostock, 606, 630, 1236, 0, 37
Thu Mar 14 19:59:54 GMT 2013, Mike Bostock, Mike Bostock, 170, 174, 344, 0, 33
Thu Mar 14 19:58:16 GMT 2013, Mike Bostock, Mike Bostock, 188, 270, 458, 0, 29
Thu Mar 14 19:36:21 GMT 2013, Mike Bostock, Mike Bostock, 523, 740, 1263, 0, 59
Thu Mar 14 17:58:17 GMT 2013, Mike Bostock, Mike Bostock, 18, 8, 26, 0, 218
Thu Mar 14 17:52:01 GMT 2013, Mike Bostock, Mike Bostock, 197, 203, 400, 0, 38
Thu Mar 14 17:34:50 GMT 2013, Mike Bostock, Mike Bostock, 192, 195, 387, 0, 42
Thu Mar 14 17:03:10 GMT 2013, Jason Davies, Jason Davies, 2716, 2392, 5108, 0, 45
Thu Mar 14 17:18:11 GMT 2013, Mike Bostock, Mike Bostock, 1004, 877, 1881, 0, 47
Thu Mar 14 16:43:53 GMT 2013, Mike Bostock, Mike Bostock, 72, 71, 143, 0, 40
Thu Mar 14 16:41:29 GMT 2013, Mike Bostock, Mike Bostock, 537, 605, 1142, 0, 39
Thu Mar 14 16:19:27 GMT 2013, Mike Bostock, Mike Bostock, 388, 388, 776, 0, 42
Thu Mar 14 16:17:39 GMT 2013, Mike Bostock, Mike Bostock, 45, 48, 93, 0, 41
Thu Mar 14 16:16:05 GMT 2013, Mike Bostock, Mike Bostock, 46, 57, 103, 0, 39
Thu Mar 14 16:09:50 GMT 2013, Mike Bostock, Mike Bostock, 52, 46, 98, 0, 39
Thu Mar 14 16:06:31 GMT 2013, Mike Bostock, Mike Bostock, 180, 176, 356, 0, 41
Thu Mar 14 16:00:13 GMT 2013, Mike Bostock, Mike Bostock, 767, 763, 1530, 0, 41
Thu Mar 14 15:46:45 GMT 2013, Mike Bostock, Mike Bostock, 44, 56, 100, 0, 31
Thu Mar 14 15:42:29 GMT 2013, Mike Bostock, Mike Bostock, 10, 9, 19, 0, 40
Thu Mar 14 15:16:52 GMT 2013, Mike Bostock, Mike Bostock, 8, 1, 9, 0, 39
Thu Mar 14 06:32:17 GMT 2013, Mike Bostock, Mike Bostock, 1, 1, 2, 0, 14
Thu Mar 14 06:21:23 GMT 2013, Mike Bostock, Mike Bostock, 3603, 3511, 7114, 0, 28
Thu Mar 14 02:16:59 GMT 2013, Mike Bostock, Mike Bostock, 69, 83, 152, 0, 32
Thu Mar 14 02:13:38 GMT 2013, Mike Bostock, Mike Bostock, 180, 192, 372, 0, 33
Thu Mar 14 02:10:53 GMT 2013, Mike Bostock, Mike Bostock, 831, 877, 1708, 0, 33
Wed Mar 13 20:58:41 GMT 2013, Mike Bostock, Mike Bostock, 52, 50, 102, 0, 36
Wed Mar 13 20:13:09 GMT 2013, Mike Bostock, Mike Bostock, 103, 102, 205, 0, 33
Wed Mar 13 20:06:33 GMT 2013, Mike Bostock, Mike Bostock, 56, 58, 114, 0, 36
Wed Mar 13 18:50:05 GMT 2013, Mike Bostock, Mike Bostock, 1, 1, 2, 0, 22
Wed Mar 13 18:46:32 GMT 2013, Mike Bostock, Mike Bostock, 28, 28, 56, 0, 39
Wed Mar 13 17:56:33 GMT 2013, Mike Bostock, Mike Bostock, 189, 48, 237, 0, 72
Wed Mar 13 17:47:58 GMT 2013, Mike Bostock, Mike Bostock, 1, 1, 2, 0, 14
Wed Mar 13 17:26:15 GMT 2013, Jason Davies, Jason Davies, 188, 47, 235, 0, 244
Wed Mar 13 15:53:00 GMT 2013, Mike Bostock, Mike Bostock, 7, 7, 14, 0, 39
Tue Mar 12 18:55:39 GMT 2013, Jason Davies, Jason Davies, 96, 11, 107, 0, 128
Wed Mar 13 09:08:02 GMT 2013, Mike Bostock, Mike Bostock, 0, 0, 0, 0, 41
Wed Mar 13 09:03:00 GMT 2013, Mike Bostock, Mike Bostock, 0, 97, 97, 0, 13
Wed Mar 13 09:01:49 GMT 2013, Mike Bostock, Mike Bostock, 2, 6, 8, 0, 23
Wed Mar 13 08:59:36 GMT 2013, Mike Bostock, Mike Bostock, 3, 3, 6, 0, 18
Wed Mar 13 08:56:00 GMT 2013, Mike Bostock, Mike Bostock, 7776, 7542, 15318, 0, 33
Wed Mar 13 06:57:44 GMT 2013, Mike Bostock, Mike Bostock, 193, 98, 291, 0, 24
Wed Mar 13 05:26:15 GMT 2013, Mike Bostock, Mike Bostock, 1144, 1024, 2168, 0, 21
Wed Mar 13 05:01:56 GMT 2013, Mike Bostock, Mike Bostock, 514, 376, 890, 0, 9
Wed Mar 13 04:31:15 GMT 2013, Mike Bostock, Mike Bostock, 25, 9, 34, 0, 19
Wed Mar 13 04:01:49 GMT 2013, Mike Bostock, Mike Bostock, 1354, 1377, 2731, 0, 6
Tue Mar 12 01:01:35 GMT 2013, Mike Bostock, Mike Bostock, 57, 28, 85, 0, 783
Mon Mar 11 23:00:08 GMT 2013, Mike Bostock, Mike Bostock, 2, 2, 4, 0, 92
Mon Mar 11 22:55:29 GMT 2013, Jason Davies, Jason Davies, 2, 2, 4, 0, 161
Mon Mar 11 22:35:05 GMT 2013, Mike Bostock, Mike Bostock, 5, 5, 10, 0, 14
Mon Mar 11 22:33:49 GMT 2013, Mike Bostock, Mike Bostock, 23, 7, 30, 0, 76
Mon Mar 11 22:33:40 GMT 2013, Mike Bostock, Mike Bostock, 419, 402, 821, 1, 36
Mon Mar 11 21:49:54 GMT 2013, Jason Davies, Jason Davies, 23, 7, 30, 0, 34
Mon Mar 11 20:43:05 GMT 2013, Mike Bostock, Mike Bostock, 859, 676, 1535, 0, 35
Mon Mar 11 19:58:00 GMT 2013, Mike Bostock, Mike Bostock, 94, 22, 116, 5, 406
Mon Mar 11 17:56:20 GMT 2013, Mike Bostock, Mike Bostock, 23, 23, 46, 0, 226
Thu Mar 07 23:14:58 GMT 2013, Mike Bostock, Mike Bostock, 5, 5, 10, 0, 16
Thu Mar 07 23:07:40 GMT 2013, Mike Bostock, Mike Bostock, 34, 21, 55, 0, 93
Thu Mar 07 23:03:56 GMT 2013, Jason Davies, Jason Davies, 34, 21, 55, 0, 143
Thu Mar 07 20:05:49 GMT 2013, Mike Bostock, Mike Bostock, 36, 5, 41, 0, 35
Thu Mar 07 17:54:19 GMT 2013, Mike Bostock, Mike Bostock, 3, 0, 3, 0, 16
Thu Mar 07 17:53:00 GMT 2013, Mike Bostock, Mike Bostock, 20, 5, 25, 0, 33
Thu Mar 07 15:56:58 GMT 2013, Mike Bostock, Mike Bostock, 432, 0, 432, 0, 112
Thu Mar 07 15:45:00 GMT 2013, Mike Bostock, Mike Bostock, 68, 7, 75, 0, 739
Thu Mar 07 15:12:47 GMT 2013, Dean Malmgren, Dean Malmgren, 366, 0, 366, 0, 49
Thu Mar 07 15:05:51 GMT 2013, Dean Malmgren, Dean Malmgren, 66, 0, 66, 0, 49
Wed Mar 06 16:54:13 GMT 2013, Jason Davies, Jason Davies, 3, 3, 6, 0, 33
Wed Mar 06 14:56:54 GMT 2013, Jason Davies, Jason Davies, 6, 6, 12, 0, 18
Wed Mar 06 13:46:42 GMT 2013, Jason Davies, Jason Davies, 76, 17, 93, 0, 50
Tue Mar 05 15:29:45 GMT 2013, Jason Davies, Jason Davies, 354, 318, 672, 0, 541
Wed Mar 06 05:08:48 GMT 2013, Mike Bostock, Mike Bostock, 30, 17, 47, 0, 199
Wed Mar 06 04:56:30 GMT 2013, Mike Bostock, Mike Bostock, 74, 41, 115, 0, 34
Wed Mar 06 04:55:52 GMT 2013, Mike Bostock, Mike Bostock, 86, 42, 128, 0, 36
Wed Mar 06 04:54:58 GMT 2013, Mike Bostock, Mike Bostock, 22, 14, 36, 0, 41
Wed Mar 06 04:50:19 GMT 2013, Mike Bostock, Mike Bostock, 261, 5, 266, 0, 70
Wed Mar 06 04:49:22 GMT 2013, Mike Bostock, Mike Bostock, 190, 3, 193, 0, 40
Wed Mar 06 04:46:22 GMT 2013, Mike Bostock, Mike Bostock, 129, 79, 208, 0, 40
Wed Mar 06 04:45:54 GMT 2013, Mike Bostock, Mike Bostock, 84, 20, 104, 0, 44
Wed Mar 06 04:45:25 GMT 2013, Mike Bostock, Mike Bostock, 120, 5, 125, 0, 36
Wed Mar 06 04:44:20 GMT 2013, Mike Bostock, Mike Bostock, 48, 3, 51, 0, 34
Wed Mar 06 04:43:51 GMT 2013, Mike Bostock, Mike Bostock, 106, 10, 116, 0, 78
Wed Mar 06 04:42:53 GMT 2013, Mike Bostock, Mike Bostock, 206, 4, 210, 0, 66
Wed Mar 06 04:41:35 GMT 2013, Mike Bostock, Mike Bostock, 2, 3, 5, 0, 159
Wed Mar 06 03:28:39 GMT 2013, Mike Bostock, Mike Bostock, 288, 126, 414, 0, 77
Tue Mar 05 18:07:34 GMT 2013, Mike Bostock, Mike Bostock, 116, 62, 178, 0, 35
Tue Mar 05 17:40:00 GMT 2013, Mike Bostock, Mike Bostock, 30, 7, 37, 0, 37
Tue Mar 05 16:59:23 GMT 2013, Mike Bostock, Mike Bostock, 104, 77, 181, 0, 161
Sat Mar 02 23:09:02 GMT 2013, Mike Bostock, Mike Bostock, 154, 153, 307, 0, 39
Mon Mar 04 23:20:44 GMT 2013, Jason Davies, Jason Davies, 122, 44, 166, 0, 44
Mon Mar 04 15:32:33 GMT 2013, Jason Davies, Jason Davies, 5, 1, 6, 0, 37
Mon Mar 04 15:08:38 GMT 2013, Jason Davies, Jason Davies, 179, 4, 183, 0, 270
Sun Mar 03 22:13:01 GMT 2013, Mike Bostock, Mike Bostock, 14, 28, 42, 0, 61
Sun Mar 03 18:28:58 GMT 2013, Mike Bostock, Mike Bostock, 12, 10, 22, 0, 33
Sun Mar 03 17:11:21 GMT 2013, Mike Bostock, Mike Bostock, 112, 60, 172, 0, 20
Sun Mar 03 17:07:10 GMT 2013, Mike Bostock, Mike Bostock, 26, 10, 36, 0, 69
Sun Mar 03 17:06:48 GMT 2013, Mike Bostock, Mike Bostock, 31, 29, 60, 0, 24
Sun Mar 03 16:57:06 GMT 2013, Mike Bostock, Mike Bostock, 1, 1, 2, 0, 70
Sun Mar 03 11:19:04 GMT 2013, Jason Davies, Jason Davies, 26, 10, 36, 0, 696
Sat Mar 02 23:09:02 GMT 2013, Mike Bostock, Mike Bostock, 183, 152, 335, 0, 77
Sat Mar 02 22:57:21 GMT 2013, Mike Bostock, Mike Bostock, 18, 12, 30, 0, 211
Sat Mar 02 22:46:45 GMT 2013, Mike Bostock, Mike Bostock, 189, 2, 191, 0, 85
Sat Mar 02 21:56:04 GMT 2013, Mike Bostock, Mike Bostock, 5, 7, 12, 0, 22
Sat Mar 02 21:54:44 GMT 2013, Mike Bostock, Mike Bostock, 27, 12, 39, 0, 49
Sat Mar 02 21:49:50 GMT 2013, Mike Bostock, Mike Bostock, 63, 12, 75, 0, 47
Sat Mar 02 18:32:22 GMT 2013, Mike Bostock, Mike Bostock, 21, 13, 34, 0, 237
Fri Mar 01 22:12:24 GMT 2013, Mike Bostock, Mike Bostock, 53, 14, 67, 0, 69
Fri Mar 01 21:59:47 GMT 2013, Mike Bostock, Mike Bostock, 80, 4, 84, 0, 78
Tue Feb 26 23:48:45 GMT 2013, Mike Bostock, Mike Bostock, 10, 1, 11, 0, 105
Mon Feb 18 12:50:11 GMT 2013, Jason Davies, Jason Davies, 105, 10, 115, 0, 28
Sat Feb 23 12:48:25 GMT 2013, Thomas Fankhauser, Thomas Fankhauser, 27, 14, 41, 0, 85
Fri Feb 22 17:40:01 GMT 2013, Thomas Fankhauser, Thomas Fankhauser, 24, 23, 47, 0, 74
Fri Feb 22 17:18:28 GMT 2013, Thomas Fankhauser, Thomas Fankhauser, 57, 8, 65, 0, 67
Fri Feb 22 16:42:51 GMT 2013, Thomas Fankhauser, Thomas Fankhauser, 3, 49, 52, 0, 29
Tue Feb 19 03:12:57 GMT 2013, Mike Bostock, Mike Bostock, 85, 41, 126, 0, 56
Mon Feb 18 13:05:42 GMT 2013, Jason Davies, Jason Davies, 47, 13, 60, 0, 177
Thu Feb 14 19:30:35 GMT 2013, Mike Bostock, Mike Bostock, 1, 1, 2, 0, 79
Thu Feb 14 19:17:57 GMT 2013, Calvin Metcalf, Calvin Metcalf, 1, 1, 2, 0, 21
Thu Feb 14 18:09:35 GMT 2013, Mike Bostock, Mike Bostock, 237, 36, 273, 0, 23
Mon Feb 11 19:56:32 GMT 2013, Mike Bostock, Mike Bostock, 74, 41, 115, 0, 379
Mon Feb 11 14:35:14 GMT 2013, Thomas Fankhauser, Thomas Fankhauser, 123, 1, 124, 0, 72
Sun Feb 10 21:14:24 GMT 2013, John Firebaugh, John Firebaugh, 12, 16, 28, 0, 19
Sat Feb 09 22:42:04 GMT 2013, John Firebaugh, John Firebaugh, 210, 4, 214, 0, 81
Thu Feb 07 14:37:29 GMT 2013, Ziggy Jonsson, Ziggy Jonsson, 1, 1, 2, 0, 88
Thu Feb 07 13:13:00 GMT 2013, Ziggy Jonsson, Ziggy Jonsson, 1, 1, 2, 0, 73
Wed Feb 06 19:04:42 GMT 2013, Mike Bostock, Mike Bostock, 424, 301, 725, 0, 20
Wed Feb 06 18:59:09 GMT 2013, Mike Bostock, Mike Bostock, 64, 51, 115, 0, 76
Wed Feb 06 18:58:29 GMT 2013, Mike Bostock, Mike Bostock, 21, 28, 49, 0, 45
Wed Feb 06 18:57:55 GMT 2013, Mike Bostock, Mike Bostock, 36, 20, 56, 0, 42
Wed Feb 06 18:57:30 GMT 2013, Mike Bostock, Mike Bostock, 21, 54, 75, 0, 35
Wed Feb 06 18:57:05 GMT 2013, Mike Bostock, Mike Bostock, 8, 8, 16, 0, 51
Wed Feb 06 18:56:37 GMT 2013, Mike Bostock, Mike Bostock, 84, 86, 170, 0, 41
Wed Feb 06 18:52:35 GMT 2013, Mike Bostock, Mike Bostock, 159, 61, 220, 0, 40
Wed Feb 06 18:52:10 GMT 2013, Mike Bostock, Mike Bostock, 30, 9, 39, 0, 39
Wed Feb 06 18:48:13 GMT 2013, Mike Bostock, Mike Bostock, 148, 53, 201, 0, 57
Wed Feb 06 18:25:19 GMT 2013, Mike Bostock, Mike Bostock, 25, 8, 33, 0, 40
Wed Feb 06 18:18:52 GMT 2013, Mike Bostock, Mike Bostock, 30, 9, 39, 2, 340
Wed Feb 06 17:47:47 GMT 2013, Mike Bostock, Mike Bostock, 5, 5, 10, 0, 105
Wed Feb 06 16:55:05 GMT 2013, Mike Bostock, Mike Bostock, 12, 13, 25, 0, 141
Wed Feb 06 16:51:20 GMT 2013, Mike Bostock, Mike Bostock, 4, 4, 8, 0, 40
Wed Feb 06 16:49:25 GMT 2013, Mike Bostock, Mike Bostock, 8, 5, 13, 0, 96
Tue Jan 22 08:54:00 GMT 2013, Jason Davies, Jason Davies, 80, 4, 84, 0, 18
Fri Feb 01 13:20:05 GMT 2013, Jason Davies, Jason Davies, 8, 0, 8, 0, 36
Fri Feb 01 19:06:29 GMT 2013, Mike Bostock, Mike Bostock, 1, 1, 2, 0, 40
Fri Feb 01 18:57:37 GMT 2013, Mike Bostock, Mike Bostock, 8, 8, 16, 0, 254
Fri Feb 01 18:30:48 GMT 2013, Mike Bostock, Mike Bostock, 21, 13, 34, 0, 92
Fri Feb 01 17:58:24 GMT 2013, Mike Bostock, Mike Bostock, 21, 54, 75, 0, 500
Fri Feb 01 16:51:47 GMT 2013, Jason Davies, Jason Davies, 5, 3, 8, 0, 27
Fri Feb 01 16:09:12 GMT 2013, Mike Bostock, Mike Bostock, 14, 8, 22, 0, 42
Thu Jan 31 23:11:40 GMT 2013, Mike Bostock, Mike Bostock, 75, 76, 151, 0, 418
Thu Jan 17 09:47:24 GMT 2013, Jason Davies, Jason Davies, 55, 50, 105, 0, 500
Thu Jan 31 13:23:54 GMT 2013, Jason Davies, Jason Davies, 13, 6, 19, 0, 46
Thu Jan 24 17:07:38 GMT 2013, Mike Bostock, Mike Bostock, 50, 1483, 1533, 0, 47
Wed Jan 23 23:38:44 GMT 2013, Mike Bostock, Mike Bostock, 73, 75, 148, 0, 641
Wed Jan 23 20:26:09 GMT 2013, Mike Bostock, Mike Bostock, 7, 13, 20, 0, 41
Wed Jan 23 18:25:35 GMT 2013, Mike Bostock, Mike Bostock, 4, 5, 9, 0, 357
Tue Jan 22 02:52:15 GMT 2013, Mike Bostock, Mike Bostock, 12, 12, 24, 0, 46
Sun Jan 20 19:50:18 GMT 2013, Mike Bostock, Mike Bostock, 4, 4, 8, 0, 28
Wed Jan 16 18:21:29 GMT 2013, Mike Bostock, Mike Bostock, 155, 58, 213, 0, 48
Tue Jan 15 18:23:30 GMT 2013, Mike Bostock, Mike Bostock, 79, 19, 98, 0, 61
Tue Jan 15 18:01:05 GMT 2013, Mike Bostock, Mike Bostock, 42, 22, 64, 0, 34
Sun Jan 13 19:02:16 GMT 2013, Mike Bostock, Mike Bostock, 37, 17, 54, 0, 178
Fri Jan 11 00:42:56 GMT 2013, Mike Bostock, Mike Bostock, 91, 46, 137, 0, 20
Fri Jan 11 00:41:55 GMT 2013, Mike Bostock, Mike Bostock, 60, 36, 96, 0, 44
Fri Jan 11 00:41:08 GMT 2013, Mike Bostock, Mike Bostock, 2, 2, 4, 0, 65
Tue Jan 08 23:42:47 GMT 2013, Mike Bostock, Mike Bostock, 4, 5, 9, 0, 191
Tue Jan 08 23:32:21 GMT 2013, Mike Bostock, Mike Bostock, 38, 3, 41, 0, 36
Tue Jan 08 23:18:59 GMT 2013, Mike Bostock, Mike Bostock, 23, 33, 56, 5, 338
Mon Jan 07 14:16:37 GMT 2013, Isaac Z. Schlueter, Isaac Z. Schlueter, 2, 2, 4, 0, 291
Sat Jan 05 01:45:43 GMT 2013, Jason Davies, Jason Davies, 26, 5, 31, 0, 76
Fri Jan 04 22:29:21 GMT 2013, Jason Davies, Jason Davies, 1, 1, 2, 0, 113
Tue Jan 01 23:52:50 GMT 2013, Mike Bostock, Mike Bostock, 44, 20, 64, 0, 20
Tue Jan 01 23:52:03 GMT 2013, Mike Bostock, Mike Bostock, 8, 3, 11, 0, 73
Tue Jan 01 23:50:17 GMT 2013, Mike Bostock, Mike Bostock, 32, 13, 45, 0, 50
Sat Dec 29 13:05:27 GMT 2012, Jason Davies, Jason Davies, 8, 3, 11, 0, 196
Fri Dec 28 17:19:30 GMT 2012, Mike Bostock, Mike Bostock, 104, 41, 145, 0, 20
Fri Dec 28 17:18:41 GMT 2012, Mike Bostock, Mike Bostock, 32, 9, 41, 0, 83
Fri Dec 28 17:18:15 GMT 2012, Mike Bostock, Mike Bostock, 51, 26, 77, 0, 75
Fri Dec 28 16:51:49 GMT 2012, Nathan Vander Wilt, Nathan Vander Wilt, 9, 9, 18, 0, 145
Fri Dec 28 16:37:24 GMT 2012, Nathan Vander Wilt, Nathan Vander Wilt, 23, 0, 23, 0, 33
Thu Dec 27 13:09:50 GMT 2012, Jason Davies, Jason Davies, 9, 11, 20, 0, 9
Thu Dec 27 12:57:52 GMT 2012, Jason Davies, Jason Davies, 43, 16, 59, 0, 50
Tue Dec 25 02:18:27 GMT 2012, Jason Davies, Jason Davies, 18, 3, 21, 0, 134
Fri Dec 21 17:18:07 GMT 2012, Mike Bostock, Mike Bostock, 5, 5, 10, 0, 15
Fri Dec 21 06:47:10 GMT 2012, Mike Bostock, Mike Bostock, 3187, 1, 3188, 0, 42
Fri Dec 21 01:21:49 GMT 2012, Mike Bostock, Mike Bostock, 2, 2, 4, 0, 30
Thu Dec 20 23:37:09 GMT 2012, Mike Bostock, Mike Bostock, 20, 10, 30, 0, 44
Thu Dec 20 23:33:13 GMT 2012, Mike Bostock, Mike Bostock, 0, 276, 276, 0, 22
Thu Dec 20 23:31:59 GMT 2012, Mike Bostock, Mike Bostock, 0, 90, 90, 0, 72
Thu Dec 20 23:31:38 GMT 2012, Mike Bostock, Mike Bostock, 0, 106, 106, 0, 74
Thu Dec 20 23:19:05 GMT 2012, Mike Bostock, Mike Bostock, 0, 229, 229, 0, 78
Thu Dec 20 22:39:56 GMT 2012, Mike Bostock, Mike Bostock, 0, 265, 265, 0, 81
Thu Dec 20 22:37:10 GMT 2012, Mike Bostock, Mike Bostock, 0, 381, 381, 0, 61
Thu Dec 20 22:13:45 GMT 2012, Mike Bostock, Mike Bostock, 0, 64, 64, 0, 71
Thu Dec 20 20:55:26 GMT 2012, Mike Bostock, Mike Bostock, 0, 111, 111, 0, 71
Thu Dec 20 20:44:12 GMT 2012, Mike Bostock, Mike Bostock, 0, 89, 89, 0, 26
Thu Dec 20 20:43:45 GMT 2012, Mike Bostock, Mike Bostock, 0, 70, 70, 0, 82
Thu Dec 20 18:29:10 GMT 2012, Mike Bostock, Mike Bostock, 0, 38, 38, 0, 75
Thu Dec 20 16:15:20 GMT 2012, Mike Bostock, Mike Bostock, 2, 0, 2, 0, 28
Thu Dec 20 06:02:30 GMT 2012, Mike Bostock, Mike Bostock, 0, 62, 62, 0, 77
Thu Dec 20 06:01:07 GMT 2012, Mike Bostock, Mike Bostock, 0, 109, 109, 0, 67
Thu Dec 20 05:35:52 GMT 2012, Mike Bostock, Mike Bostock, 0, 255, 255, 0, 65
Thu Dec 20 01:07:27 GMT 2012, Mike Bostock, Mike Bostock, 0, 154, 154, 0, 65
Thu Dec 20 01:01:55 GMT 2012, Mike Bostock, Mike Bostock, 0, 70, 70, 0, 27
Thu Dec 20 00:52:08 GMT 2012, Mike Bostock, Mike Bostock, 0, 157, 157, 0, 74
Thu Dec 20 00:51:52 GMT 2012, Mike Bostock, Mike Bostock, 0, 115, 115, 0, 73
Thu Dec 20 00:50:07 GMT 2012, Mike Bostock, Mike Bostock, 0, 0, 0, 0, 28
Thu Dec 20 00:43:06 GMT 2012, Mike Bostock, Mike Bostock, 0, 58, 58, 0, 69
Thu Dec 20 00:32:54 GMT 2012, Mike Bostock, Mike Bostock, 0, 129, 129, 0, 68
Thu Dec 20 00:31:52 GMT 2012, Mike Bostock, Mike Bostock, 0, 51, 51, 0, 63
Thu Dec 20 00:30:40 GMT 2012, Mike Bostock, Mike Bostock, 0, 73, 73, 0, 25
Thu Dec 20 00:27:09 GMT 2012, Mike Bostock, Mike Bostock, 0, 69, 69, 0, 62
Wed Dec 19 23:40:31 GMT 2012, Mike Bostock, Mike Bostock, 0, 7483, 7483, 0, 13
Wed Dec 19 23:39:42 GMT 2012, Mike Bostock, Mike Bostock, 0, 186, 186, 0, 21
Wed Dec 19 23:38:37 GMT 2012, Mike Bostock, Mike Bostock, 0, 56, 56, 0, 68
Wed Dec 19 23:38:01 GMT 2012, Mike Bostock, Mike Bostock, 0, 69, 69, 0, 63
Wed Dec 19 23:29:47 GMT 2012, Mike Bostock, Mike Bostock, 0, 164, 164, 0, 65
Wed Dec 19 23:22:16 GMT 2012, Mike Bostock, Mike Bostock, 0, 64, 64, 0, 65
Wed Dec 19 23:14:50 GMT 2012, Mike Bostock, Mike Bostock, 0, 537, 537, 0, 67
Wed Dec 19 23:11:57 GMT 2012, Mike Bostock, Mike Bostock, 0, 135, 135, 0, 63
Wed Dec 19 23:10:27 GMT 2012, Mike Bostock, Mike Bostock, 0, 118, 118, 0, 64
Wed Dec 19 22:47:14 GMT 2012, Mike Bostock, Mike Bostock, 0, 38, 38, 0, 67
Wed Dec 19 22:33:19 GMT 2012, Mike Bostock, Mike Bostock, 0, 10794, 10794, 0, 68
Wed Dec 19 22:31:38 GMT 2012, Mike Bostock, Mike Bostock, 0, 87, 87, 0, 73
Wed Dec 19 20:55:44 GMT 2012, Mike Bostock, Mike Bostock, 2, 0, 2, 0, 26
Wed Dec 19 20:53:05 GMT 2012, Mike Bostock, Mike Bostock, 0, 0, 0, 0, 16
Wed Dec 19 20:50:07 GMT 2012, Mike Bostock, Mike Bostock, 0, 0, 0, 0, 21
Wed Dec 19 20:41:01 GMT 2012, Mike Bostock, Mike Bostock, 0, 136, 136, 0, 76
Wed Dec 19 20:21:03 GMT 2012, Mike Bostock, Mike Bostock, 0, 61, 61, 0, 75
Wed Dec 19 20:20:14 GMT 2012, Mike Bostock, Mike Bostock, 5, 0, 5, 0, 23
Wed Dec 19 19:52:49 GMT 2012, Mike Bostock, Mike Bostock, 0, 103, 103, 0, 62
Wed Dec 19 19:51:53 GMT 2012, Mike Bostock, Mike Bostock, 0, 88, 88, 0, 63
Wed Dec 19 19:51:07 GMT 2012, Mike Bostock, Mike Bostock, 0, 217, 217, 0, 107
Wed Dec 19 19:50:25 GMT 2012, Mike Bostock, Mike Bostock, 0, 63, 63, 0, 65
Wed Dec 19 19:47:54 GMT 2012, Mike Bostock, Mike Bostock, 1, 6, 7, 0, 35
Wed Dec 19 19:47:01 GMT 2012, Mike Bostock, Mike Bostock, 0, 101, 101, 0, 63
Wed Dec 19 19:46:48 GMT 2012, Mike Bostock, Mike Bostock, 0, 126, 126, 0, 71
Wed Dec 19 19:45:21 GMT 2012, Mike Bostock, Mike Bostock, 0, 97, 97, 0, 68
Wed Dec 19 19:43:54 GMT 2012, Mike Bostock, Mike Bostock, 0, 224, 224, 0, 77
Wed Dec 19 19:43:31 GMT 2012, Mike Bostock, Mike Bostock, 0, 600, 600, 0, 28
Wed Dec 19 19:42:54 GMT 2012, Mike Bostock, Mike Bostock, 0, 73, 73, 0, 69
Wed Dec 19 19:42:16 GMT 2012, Mike Bostock, Mike Bostock, 0, 57, 57, 0, 82
Wed Dec 19 19:41:51 GMT 2012, Mike Bostock, Mike Bostock, 0, 78, 78, 0, 68
Wed Dec 19 19:41:26 GMT 2012, Mike Bostock, Mike Bostock, 0, 109, 109, 0, 72
Wed Dec 19 19:41:07 GMT 2012, Mike Bostock, Mike Bostock, 0, 98, 98, 0, 71
Wed Dec 19 19:38:08 GMT 2012, Mike Bostock, Mike Bostock, 0, 69, 69, 0, 69
Wed Dec 19 19:23:19 GMT 2012, Mike Bostock, Mike Bostock, 0, 159, 159, 0, 64
Wed Dec 19 19:22:13 GMT 2012, Mike Bostock, Mike Bostock, 0, 125, 125, 0, 65
Wed Dec 19 19:20:29 GMT 2012, Mike Bostock, Mike Bostock, 0, 103, 103, 0, 67
Wed Dec 19 19:19:31 GMT 2012, Mike Bostock, Mike Bostock, 0, 125, 125, 0, 61
Wed Dec 19 19:18:43 GMT 2012, Mike Bostock, Mike Bostock, 0, 66, 66, 0, 70
Wed Dec 19 19:16:04 GMT 2012, Mike Bostock, Mike Bostock, 0, 67, 67, 0, 63
Wed Dec 19 19:14:19 GMT 2012, Mike Bostock, Mike Bostock, 0, 45, 45, 0, 60
Wed Dec 19 19:08:26 GMT 2012, Mike Bostock, Mike Bostock, 0, 187, 187, 0, 100
Wed Dec 19 19:07:26 GMT 2012, Mike Bostock, Mike Bostock, 0, 327, 327, 0, 62
Wed Dec 19 19:06:25 GMT 2012, Mike Bostock, Mike Bostock, 0, 149, 149, 0, 145
Wed Dec 19 19:05:38 GMT 2012, Mike Bostock, Mike Bostock, 0, 314, 314, 0, 143
Wed Dec 19 19:04:28 GMT 2012, Mike Bostock, Mike Bostock, 0, 258, 258, 0, 100
Wed Dec 19 18:54:39 GMT 2012, Mike Bostock, Mike Bostock, 0, 135, 135, 0, 65
Wed Dec 19 18:54:01 GMT 2012, Mike Bostock, Mike Bostock, 0, 46, 46, 0, 59
Wed Dec 19 18:53:16 GMT 2012, Mike Bostock, Mike Bostock, 0, 54, 54, 0, 66
Wed Dec 19 18:49:10 GMT 2012, Mike Bostock, Mike Bostock, 0, 61, 61, 0, 60
Wed Dec 19 18:48:42 GMT 2012, Mike Bostock, Mike Bostock, 0, 89, 89, 0, 59
Wed Dec 19 18:45:26 GMT 2012, Mike Bostock, Mike Bostock, 0, 134, 134, 0, 60
Wed Dec 19 18:43:25 GMT 2012, Mike Bostock, Mike Bostock, 0, 122, 122, 0, 61
Wed Dec 19 18:38:01 GMT 2012, Mike Bostock, Mike Bostock, 0, 68, 68, 0, 60
Wed Dec 19 18:32:17 GMT 2012, Mike Bostock, Mike Bostock, 0, 65, 65, 0, 63
Wed Dec 19 18:31:50 GMT 2012, Mike Bostock, Mike Bostock, 0, 124, 124, 0, 61
Wed Dec 19 18:31:30 GMT 2012, Mike Bostock, Mike Bostock, 0, 60, 60, 0, 62
Wed Dec 19 18:31:10 GMT 2012, Mike Bostock, Mike Bostock, 0, 88, 88, 0, 74
Wed Dec 19 18:30:32 GMT 2012, Mike Bostock, Mike Bostock, 0, 76, 76, 0, 63
Wed Dec 19 18:29:22 GMT 2012, Mike Bostock, Mike Bostock, 0, 22, 22, 0, 22
Wed Dec 19 18:29:00 GMT 2012, Mike Bostock, Mike Bostock, 0, 162, 162, 0, 72
Wed Dec 19 18:21:29 GMT 2012, Mike Bostock, Mike Bostock, 0, 102, 102, 0, 63
Wed Dec 19 18:12:32 GMT 2012, Mike Bostock, Mike Bostock, 0, 98, 98, 0, 71
Wed Dec 19 18:11:39 GMT 2012, Mike Bostock, Mike Bostock, 0, 79, 79, 0, 66
Wed Dec 19 18:11:12 GMT 2012, Mike Bostock, Mike Bostock, 0, 656, 656, 0, 68
Wed Dec 19 18:10:18 GMT 2012, Mike Bostock, Mike Bostock, 0, 68, 68, 0, 67
Wed Dec 19 18:09:03 GMT 2012, Mike Bostock, Mike Bostock, 0, 742, 742, 0, 66
Wed Dec 19 04:38:45 GMT 2012, Mike Bostock, Mike Bostock, 3, 10, 13, 0, 10
Wed Dec 19 04:36:32 GMT 2012, Mike Bostock, Mike Bostock, 16, 31, 47, 0, 44
Wed Dec 19 04:21:22 GMT 2012, Mike Bostock, Mike Bostock, 24, 3, 27, 0, 34
Wed Dec 19 01:36:43 GMT 2012, Mike Bostock, Mike Bostock, 17, 6, 23, 0, 114
Tue Dec 18 19:38:12 GMT 2012, Mike Bostock, Mike Bostock, 20, 10, 30, 0, 92
Tue Dec 18 02:32:06 GMT 2012, Mike Bostock, Mike Bostock, 3, 3, 6, 0, 43
Mon Dec 17 22:57:21 GMT 2012, Jason Davies, Jason Davies, 36, 7, 43, 0, 296
Mon Dec 17 17:44:55 GMT 2012, Jason Davies, Jason Davies, 5, 5, 10, 0, 24
Mon Dec 17 21:40:41 GMT 2012, Mike Bostock, Mike Bostock, 7, 8, 15, 0, 45
Mon Dec 17 11:23:42 GMT 2012, Jason Davies, Jason Davies, 9, 1, 10, 0, 29
Sun Dec 16 23:57:39 GMT 2012, Jason Davies, Jason Davies, 54, 54, 108, 0, 192
Sat Dec 15 22:23:05 GMT 2012, Mike Bostock, Mike Bostock, 3, 2, 5, 0, 41
Sat Dec 15 21:25:36 GMT 2012, Mike Bostock, Mike Bostock, 9, 18, 27, 0, 33
Sat Dec 15 21:07:29 GMT 2012, Mike Bostock, Mike Bostock, 14, 34, 48, 0, 48
Sat Dec 15 21:02:08 GMT 2012, Mike Bostock, Mike Bostock, 0, 21, 21, 0, 19
Sat Dec 15 21:01:53 GMT 2012, Mike Bostock, Mike Bostock, 3, 3, 6, 0, 25
Sat Dec 15 20:59:55 GMT 2012, Mike Bostock, Mike Bostock, 83, 103, 186, 0, 39
Sat Dec 15 20:48:22 GMT 2012, Mike Bostock, Mike Bostock, 34, 45, 79, 0, 36
Sat Dec 15 20:42:00 GMT 2012, Mike Bostock, Mike Bostock, 612, 634, 1246, 0, 107
Sat Dec 15 14:40:53 GMT 2012, Jason Davies, Jason Davies, 8, 7, 15, 0, 32
Sat Dec 15 02:35:02 GMT 2012, Mike Bostock, Mike Bostock, 66, 75, 141, 0, 43
Fri Dec 14 13:26:43 GMT 2012, Jason Davies, Jason Davies, 3, 3, 6, 0, 12
Fri Dec 14 01:12:10 GMT 2012, Jason Davies, Jason Davies, 14, 5, 19, 0, 64
Fri Dec 14 01:29:46 GMT 2012, Jason Davies, Jason Davies, 66, 17, 83, 0, 44
Thu Dec 13 21:55:00 GMT 2012, Jason Davies, Jason Davies, 28, 17, 45, 0, 48
Fri Dec 14 00:05:59 GMT 2012, Mike Bostock, Mike Bostock, 9, 14, 23, 0, 30
Thu Dec 13 19:20:47 GMT 2012, Jason Davies, Jason Davies, 5, 5, 10, 0, 86
Thu Dec 13 19:11:38 GMT 2012, Jason Davies, Jason Davies, 3, 3, 6, 0, 46
Thu Dec 13 19:09:15 GMT 2012, Jason Davies, Jason Davies, 7, 3, 10, 0, 46
Thu Dec 13 18:59:59 GMT 2012, Jason Davies, Jason Davies, 3, 3, 6, 0, 162
Thu Dec 13 17:50:37 GMT 2012, Mike Bostock, Mike Bostock, 42, 30, 72, 0, 33
Thu Dec 13 17:34:02 GMT 2012, Mike Bostock, Mike Bostock, 5, 5, 10, 0, 21
Thu Dec 13 16:01:11 GMT 2012, Jason Davies, Jason Davies, 0, 1, 1, 0, 12
Thu Dec 13 15:59:45 GMT 2012, Jason Davies, Jason Davies, 49, 31, 80, 0, 28
Thu Dec 13 15:34:55 GMT 2012, Jason Davies, Jason Davies, 6, 6, 12, 0, 78
Thu Dec 13 14:53:46 GMT 2012, Jason Davies, Jason Davies, 140, 124, 264, 0, 21
Thu Dec 13 13:51:46 GMT 2012, Jason Davies, Jason Davies, 1, 3, 4, 0, 18
Thu Dec 13 13:29:17 GMT 2012, Jason Davies, Jason Davies, 86, 19, 105, 0, 95
Thu Dec 13 13:10:44 GMT 2012, Jason Davies, Jason Davies, 11, 10, 21, 0, 39
Thu Dec 13 13:00:51 GMT 2012, Jason Davies, Jason Davies, 39, 9, 48, 0, 120
Thu Dec 13 12:48:36 GMT 2012, Jason Davies, Jason Davies, 30, 12, 42, 0, 331
Thu Dec 13 12:22:41 GMT 2012, Jason Davies, Jason Davies, 134, 388, 522, 0, 44
Thu Dec 13 10:58:40 GMT 2012, Jason Davies, Jason Davies, 53, 23, 76, 0, 21
Thu Dec 13 10:57:38 GMT 2012, Jason Davies, Jason Davies, 16, 3, 19, 0, 121
Thu Dec 13 05:22:54 GMT 2012, Mike Bostock, Mike Bostock, 22, 15, 37, 0, 28
Thu Dec 13 03:02:09 GMT 2012, Mike Bostock, Mike Bostock, 11, 11, 22, 0, 36
Thu Dec 13 02:54:10 GMT 2012, Mike Bostock, Mike Bostock, 12, 14, 26, 0, 38
Thu Dec 13 02:39:50 GMT 2012, Jason Davies, Jason Davies, 9, 5, 14, 0, 88
Wed Dec 12 22:58:01 GMT 2012, Jason Davies, Jason Davies, 262, 155, 417, 0, 31
Thu Dec 13 01:15:05 GMT 2012, Mike Bostock, Mike Bostock, 83, 50, 133, 0, 38
Thu Dec 13 00:54:58 GMT 2012, Mike Bostock, Mike Bostock, 35, 35, 70, 0, 108
Thu Dec 13 00:42:07 GMT 2012, Mike Bostock, Mike Bostock, 91, 85, 176, 0, 35
Thu Dec 13 00:18:39 GMT 2012, Mike Bostock, Mike Bostock, 11, 4, 15, 0, 26
Thu Dec 13 00:17:02 GMT 2012, Mike Bostock, Mike Bostock, 158, 222, 380, 0, 49
Wed Dec 12 23:52:54 GMT 2012, Mike Bostock, Mike Bostock, 4, 1, 5, 0, 30
Wed Dec 12 23:48:37 GMT 2012, Mike Bostock, Mike Bostock, 86, 65, 151, 0, 40
Wed Dec 12 23:30:30 GMT 2012, Mike Bostock, Mike Bostock, 3, 3, 6, 0, 39
Wed Dec 12 23:23:55 GMT 2012, Mike Bostock, Mike Bostock, 4, 7, 11, 0, 98
Wed Dec 12 23:16:49 GMT 2012, Mike Bostock, Mike Bostock, 1, 23, 24, 0, 66
Wed Dec 12 23:07:09 GMT 2012, Mike Bostock, Mike Bostock, 3, 3, 6, 0, 18
Wed Dec 12 22:59:51 GMT 2012, Mike Bostock, Mike Bostock, 30, 34, 64, 0, 22
Wed Dec 12 22:57:24 GMT 2012, Mike Bostock, Mike Bostock, 94, 124, 218, 0, 40
Wed Dec 12 22:19:52 GMT 2012, Mike Bostock, Mike Bostock, 12, 15, 27, 0, 32
Wed Dec 12 22:13:03 GMT 2012, Mike Bostock, Mike Bostock, 484, 509, 993, 0, 73
Wed Dec 12 21:56:41 GMT 2012, Mike Bostock, Mike Bostock, 328, 72, 400, 0, 28
Wed Dec 12 21:33:59 GMT 2012, Jason Davies, Jason Davies, 543, 573, 1116, 0, 98
Wed Dec 12 19:32:08 GMT 2012, Mike Bostock, Mike Bostock, 84, 68, 152, 0, 21
Wed Dec 12 18:40:03 GMT 2012, Mike Bostock, Mike Bostock, 1, 1, 2, 0, 38
Wed Dec 12 18:38:20 GMT 2012, Mike Bostock, Mike Bostock, 15, 10, 25, 0, 42
Wed Dec 12 18:35:14 GMT 2012, Mike Bostock, Mike Bostock, 55, 44, 99, 0, 43
Wed Dec 12 18:17:52 GMT 2012, Mike Bostock, Mike Bostock, 76, 23, 99, 0, 36
Wed Dec 12 18:16:27 GMT 2012, Mike Bostock, Mike Bostock, 80, 0, 80, 0, 31
Wed Dec 12 17:09:21 GMT 2012, Mike Bostock, Mike Bostock, 159, 4, 163, 0, 77
Wed Dec 12 13:51:10 GMT 2012, Jason Davies, Jason Davies, 7, 7, 14, 0, 19
Wed Dec 12 12:08:50 GMT 2012, Jason Davies, Jason Davies, 5, 5, 10, 0, 19
Wed Dec 12 12:00:29 GMT 2012, Jason Davies, Jason Davies, 4, 3, 7, 0, 167
Wed Dec 12 11:25:29 GMT 2012, Jason Davies, Jason Davies, 28, 22, 50, 0, 48
Wed Dec 12 10:20:49 GMT 2012, Jason Davies, Jason Davies, 36, 57, 93, 0, 137
Wed Dec 12 09:37:33 GMT 2012, Jason Davies, Jason Davies, 18, 17, 35, 0, 32
Wed Dec 12 09:25:22 GMT 2012, Jason Davies, Jason Davies, 191, 179, 370, 0, 24
Wed Dec 12 09:19:58 GMT 2012, Jason Davies, Jason Davies, 23, 31, 54, 0, 34
Wed Dec 12 08:43:32 GMT 2012, Jason Davies, Jason Davies, 13, 6, 19, 0, 25
Wed Dec 12 05:55:40 GMT 2012, Mike Bostock, Mike Bostock, 10, 4, 14, 0, 11
Wed Dec 12 05:50:57 GMT 2012, Mike Bostock, Mike Bostock, 90, 90, 180, 0, 24
Wed Dec 12 05:31:12 GMT 2012, Mike Bostock, Mike Bostock, 13, 4, 17, 0, 11
Wed Dec 12 05:22:50 GMT 2012, Mike Bostock, Mike Bostock, 23, 17, 40, 0, 171
Wed Dec 12 05:04:34 GMT 2012, Mike Bostock, Mike Bostock, 29, 35, 64, 0, 25
Wed Dec 12 00:11:08 GMT 2012, Jason Davies, Jason Davies, 45, 83, 128, 0, 130
Tue Dec 11 21:58:45 GMT 2012, Jason Davies, Jason Davies, 77, 80, 157, 0, 114
Tue Dec 11 20:40:58 GMT 2012, Jason Davies, Jason Davies, 738, 653, 1391, 0, 50
Tue Dec 11 19:55:01 GMT 2012, Mike Bostock, Mike Bostock, 95, 138, 233, 0, 45
Tue Dec 11 19:26:09 GMT 2012, Mike Bostock, Mike Bostock, 16, 4, 20, 0, 33
Tue Dec 11 19:16:45 GMT 2012, Mike Bostock, Mike Bostock, 2, 2, 4, 0, 13
Tue Dec 11 19:03:41 GMT 2012, Mike Bostock, Mike Bostock, 62, 30, 92, 0, 153
Tue Dec 11 18:21:44 GMT 2012, Mike Bostock, Mike Bostock, 88, 63, 151, 0, 48
Tue Dec 11 00:23:27 GMT 2012, Jason Davies, Jason Davies, 708, 674, 1382, 0, 46
Mon Dec 10 23:41:13 GMT 2012, Mike Bostock, Mike Bostock, 17, 17, 34, 0, 35
Mon Dec 10 21:23:27 GMT 2012, Jason Davies, Jason Davies, 94, 92, 186, 0, 34
Mon Dec 10 22:55:20 GMT 2012, Mike Bostock, Mike Bostock, 10, 8, 18, 0, 31
Mon Dec 10 22:49:20 GMT 2012, Mike Bostock, Mike Bostock, 126, 116, 242, 0, 46
Mon Dec 10 20:04:58 GMT 2012, Mike Bostock, Mike Bostock, 71, 103, 174, 0, 64
Mon Dec 10 16:40:29 GMT 2012, Mike Bostock, Mike Bostock, 62, 5, 67, 0, 69
Mon Dec 10 11:26:37 GMT 2012, Jason Davies, Jason Davies, 62, 5, 67, 0, 23
Sun Dec 09 21:44:05 GMT 2012, Mike Bostock, Mike Bostock, 2, 4, 6, 0, 25
Sun Dec 09 20:46:14 GMT 2012, Jason Davies, Jason Davies, 7, 4, 11, 0, 47
Sun Dec 09 20:32:01 GMT 2012, Jason Davies, Jason Davies, 30, 6, 36, 0, 35
Sat Dec 08 14:48:16 GMT 2012, Jason Davies, Jason Davies, 208, 4, 212, 0, 27
Fri Dec 07 18:41:53 GMT 2012, Jason Davies, Mike Bostock, 7, 13, 20, 0, 9
Thu Dec 06 17:15:47 GMT 2012, Jason Davies, Mike Bostock, 272, 27, 299, 0, 113
Sat Dec 08 16:26:39 GMT 2012, Mike Bostock, Mike Bostock, 5, 5, 10, 0, 51
Sat Dec 08 14:48:54 GMT 2012, Jason Davies, Jason Davies, 5, 5, 10, 0, 7
Fri Dec 07 20:44:21 GMT 2012, Mike Bostock, Mike Bostock, 20, 3, 23, 0, 27
Fri Dec 07 03:50:36 GMT 2012, Mike Bostock, Mike Bostock, 28, 4, 32, 0, 32
Thu Dec 06 17:14:58 GMT 2012, Mike Bostock, Mike Bostock, 13, 13, 26, 0, 73
Thu Dec 06 17:13:53 GMT 2012, Mike Bostock, Mike Bostock, 211, 233, 444, 0, 69
Thu Dec 06 16:45:36 GMT 2012, Mike Bostock, Mike Bostock, 6, 6, 12, 0, 88
Thu Dec 06 10:40:06 GMT 2012, Jason Davies, Jason Davies, 22, 11, 33, 0, 50
Thu Dec 06 09:58:38 GMT 2012, Jason Davies, Jason Davies, 1, 1, 2, 0, 31
Thu Dec 06 09:44:18 GMT 2012, Jason Davies, Jason Davies, 73, 105, 178, 0, 9
Thu Dec 06 09:17:53 GMT 2012, Jason Davies, Jason Davies, 110, 130, 240, 0, 30
Thu Dec 06 00:56:24 GMT 2012, Jason Davies, Jason Davies, 40, 29, 69, 0, 26
Thu Dec 06 00:39:57 GMT 2012, Jason Davies, Jason Davies, 35, 15, 50, 0, 46
Wed Dec 05 20:58:43 GMT 2012, Jason Davies, Jason Davies, 44, 72, 116, 0, 52
Wed Dec 05 20:35:50 GMT 2012, Jason Davies, Jason Davies, 61, 45, 106, 0, 78
Wed Dec 05 20:12:45 GMT 2012, Mike Bostock, Mike Bostock, 3, 3, 6, 1, 17
Wed Dec 05 20:04:18 GMT 2012, Jason Davies, Jason Davies, 70, 21, 91, 0, 29
Wed Dec 05 18:55:24 GMT 2012, Jason Davies, Jason Davies, 107, 83, 190, 0, 39
Wed Dec 05 18:39:57 GMT 2012, Jason Davies, Jason Davies, 72, 50, 122, 0, 203
Wed Dec 05 18:16:35 GMT 2012, Jason Davies, Jason Davies, 18, 8, 26, 0, 344
Wed Dec 05 17:48:24 GMT 2012, Mike Bostock, Mike Bostock, 8, 18, 26, 0, 41
Thu Nov 29 09:25:37 GMT 2012, Jason Davies, Mike Bostock, 36, 0, 36, 0, 159
Thu Nov 22 20:14:23 GMT 2012, Jason Davies, Mike Bostock, 380, 235, 615, 0, 219
Thu Nov 22 19:34:57 GMT 2012, Jason Davies, Mike Bostock, 20, 3, 23, 0, 37
Wed Nov 21 12:02:10 GMT 2012, Jason Davies, Mike Bostock, 4, 4, 8, 0, 100
Wed Nov 21 09:55:00 GMT 2012, Jason Davies, Mike Bostock, 29, 12, 41, 0, 37
Tue Dec 04 21:00:41 GMT 2012, Jason Davies, Jason Davies, 4, 4, 8, 0, 22
Tue Dec 04 20:56:14 GMT 2012, Jason Davies, Jason Davies, 43, 7, 50, 0, 193
Fri Nov 30 18:25:12 GMT 2012, Mike Bostock, Mike Bostock, 24, 21, 45, 0, 53
Mon Nov 26 23:47:06 GMT 2012, Mike Bostock, Mike Bostock, 6, 6, 12, 0, 40
Wed Nov 21 17:35:15 GMT 2012, Jason Davies, Jason Davies, 7, 4, 11, 0, 18
Wed Nov 21 15:56:46 GMT 2012, Jason Davies, Jason Davies, 30, 22, 52, 0, 37
Wed Nov 21 15:22:57 GMT 2012, Jason Davies, Jason Davies, 170, 117, 287, 0, 135
Wed Nov 21 00:54:32 GMT 2012, Jason Davies, Jason Davies, 10, 3, 13, 0, 31
Wed Nov 21 00:36:25 GMT 2012, Jason Davies, Jason Davies, 9, 7, 16, 0, 25
Tue Nov 20 18:15:11 GMT 2012, Jason Davies, Jason Davies, 177, 133, 310, 0, 619
Sun Nov 18 15:53:29 GMT 2012, Jason Davies, Jason Davies, 208, 97, 305, 0, 21
Sun Nov 18 20:05:33 GMT 2012, Jason Davies, Jason Davies, 13, 54, 67, 0, 9
Sun Nov 18 18:21:55 GMT 2012, Mike Bostock, Mike Bostock, 30, 25, 55, 0, 64
Sun Nov 18 18:16:01 GMT 2012, Mike Bostock, Mike Bostock, 1, 34, 35, 0, 31
Sun Nov 18 18:15:13 GMT 2012, Mike Bostock, Mike Bostock, 18, 20, 38, 0, 30
Sun Nov 18 18:12:41 GMT 2012, Mike Bostock, Mike Bostock, 42, 177, 219, 0, 90
Sun Nov 18 17:12:10 GMT 2012, Mike Bostock, Mike Bostock, 37, 47, 84, 0, 27
Sun Nov 18 17:06:38 GMT 2012, Mike Bostock, Mike Bostock, 6, 22, 28, 0, 11
Sun Nov 18 17:01:00 GMT 2012, Mike Bostock, Mike Bostock, 5, 11, 16, 0, 38
Sun Nov 18 16:46:43 GMT 2012, Mike Bostock, Mike Bostock, 8, 8, 16, 0, 9
Sun Nov 18 16:40:57 GMT 2012, Mike Bostock, Mike Bostock, 8, 108, 116, 0, 650
Sun Nov 18 16:29:37 GMT 2012, Mike Bostock, Mike Bostock, 94, 106, 200, 0, 38
Sun Nov 18 15:40:10 GMT 2012, Mike Bostock, Mike Bostock, 90, 95, 185, 0, 20
Sat Nov 17 17:56:07 GMT 2012, Jason Davies, Jason Davies, 30, 25, 55, 0, 49
Fri Nov 16 09:34:46 GMT 2012, Jason Davies, Jason Davies, 3, 1, 4, 0, 115
Fri Nov 16 09:08:46 GMT 2012, Jason Davies, Jason Davies, 6, 0, 6, 0, 33
Thu Nov 15 23:27:14 GMT 2012, Jason Davies, Jason Davies, 21, 6, 27, 0, 37
Thu Nov 15 20:33:31 GMT 2012, Jason Davies, Jason Davies, 15, 16, 31, 0, 44
Thu Nov 15 16:06:17 GMT 2012, Jason Davies, Jason Davies, 6, 5, 11, 0, 48
Wed Nov 14 23:23:54 GMT 2012, Jason Davies, Jason Davies, 30, 21, 51, 0, 349
Wed Nov 14 16:19:24 GMT 2012, Jason Davies, Jason Davies, 3, 3, 6, 0, 7
Wed Nov 14 14:51:11 GMT 2012, Jason Davies, Jason Davies, 37, 26, 63, 0, 43
Wed Nov 14 14:07:33 GMT 2012, Jason Davies, Jason Davies, 6, 4, 10, 0, 48
Wed Nov 14 13:07:19 GMT 2012, Jason Davies, Jason Davies, 15, 5, 20, 0, 45
Wed Nov 14 12:44:29 GMT 2012, Jason Davies, Jason Davies, 29, 8, 37, 0, 43
Wed Nov 14 11:49:47 GMT 2012, Jason Davies, Jason Davies, 26, 3, 29, 0, 34
Tue Nov 13 22:51:56 GMT 2012, Jason Davies, Jason Davies, 11, 15, 26, 0, 24
Tue Nov 13 22:50:52 GMT 2012, Jason Davies, Jason Davies, 3, 3, 6, 0, 79
Tue Nov 13 13:28:46 GMT 2012, Jason Davies, Jason Davies, 3, 3, 6, 0, 42
Tue Nov 13 13:21:28 GMT 2012, Jason Davies, Jason Davies, 11, 22, 33, 0, 9
Tue Nov 13 13:07:27 GMT 2012, Jason Davies, Jason Davies, 7, 6, 13, 0, 146
Sun Nov 11 19:23:35 GMT 2012, Mike Bostock, Mike Bostock, 4, 4, 8, 0, 9
Sun Nov 11 19:22:44 GMT 2012, Mike Bostock, Mike Bostock, 4, 7634, 7638, 0, 31
Sun Nov 11 19:20:15 GMT 2012, Mike Bostock, Mike Bostock, 1558, 1882, 3440, 0, 17
Sun Nov 11 17:44:40 GMT 2012, Mike Bostock, Mike Bostock, 57, 100, 157, 0, 16
Sun Nov 11 17:28:41 GMT 2012, Mike Bostock, Mike Bostock, 23, 9, 32, 0, 74
Sun Nov 11 17:25:53 GMT 2012, Mike Bostock, Mike Bostock, 82, 41, 123, 0, 93
Sat Nov 10 23:24:27 GMT 2012, Jason Davies, Jason Davies, 7, 7, 14, 0, 26
Sat Nov 10 23:23:06 GMT 2012, Jason Davies, Jason Davies, 3, 3, 6, 0, 51
Sat Nov 10 21:57:56 GMT 2012, Jason Davies, Jason Davies, 17, 12, 29, 0, 76
Sat Nov 10 18:23:57 GMT 2012, Jason Davies, Jason Davies, 74, 38, 112, 0, 148
Fri Nov 02 23:47:18 GMT 2012, Jason Davies, Jason Davies, 23, 9, 32, 0, 63
Fri Nov 02 21:15:35 GMT 2012, Mike Bostock, Mike Bostock, 9, 16, 25, 0, 43
Fri Nov 02 19:50:20 GMT 2012, Mike Bostock, Mike Bostock, 4835, 4812, 9647, 0, 20
Wed Oct 31 09:12:26 GMT 2012, Jason Davies, Jason Davies, 3, 3, 6, 0, 9
Wed Oct 31 01:00:57 GMT 2012, Jason Davies, Jason Davies, 14, 14, 28, 0, 104
Tue Oct 30 21:42:05 GMT 2012, Mike Bostock, Mike Bostock, 95, 60, 155, 0, 218
Tue Oct 30 02:49:35 GMT 2012, Mike Bostock, Mike Bostock, 33, 23, 56, 0, 33
Mon Oct 29 17:17:35 GMT 2012, Mike Bostock, Mike Bostock, 13, 4, 17, 0, 99
Mon Oct 29 16:42:33 GMT 2012, Mike Bostock, Mike Bostock, 0, 14, 14, 0, 22
Mon Oct 29 16:35:01 GMT 2012, Mike Bostock, Mike Bostock, 150, 40, 190, 0, 103
Mon Oct 29 16:23:18 GMT 2012, Mike Bostock, Mike Bostock, 100, 70, 170, 0, 65
Mon Oct 29 16:07:00 GMT 2012, Mike Bostock, Mike Bostock, 60, 45, 105, 1, 159
Mon Oct 29 15:50:22 GMT 2012, Mike Bostock, Mike Bostock, 25, 26, 51, 0, 136
Sat Oct 27 01:28:27 BST 2012, Mike Bostock, Mike Bostock, 15, 11, 26, 0, 33
Thu Oct 25 18:38:23 BST 2012, Mike Bostock, Mike Bostock, 70, 6, 76, 0, 91
Thu Oct 25 18:29:24 BST 2012, Jason Davies, Jason Davies, 70, 6, 76, 0, 39
Fri Oct 19 06:19:32 BST 2012, Mike Bostock, Mike Bostock, 50, 58, 108, 0, 498
Wed Oct 17 05:51:11 BST 2012, Mike Bostock, Mike Bostock, 12, 10, 22, 0, 46
Wed Oct 17 01:17:35 BST 2012, Mike Bostock, Mike Bostock, 80, 96, 176, 0, 29
Wed Oct 17 00:58:37 BST 2012, Mike Bostock, Mike Bostock, 89, 88, 177, 0, 22
Wed Oct 17 00:40:46 BST 2012, Mike Bostock, Mike Bostock, 141, 108, 249, 0, 653
Tue Oct 16 22:02:08 BST 2012, Mike Bostock, Mike Bostock, 8, 12, 20, 0, 298
Tue Oct 16 21:14:28 BST 2012, Mike Bostock, Mike Bostock, 3, 3, 6, 0, 42
Mon Oct 15 16:13:40 BST 2012, Mike Bostock, Mike Bostock, 23, 4, 27, 0, 267
Fri Oct 12 01:10:26 BST 2012, Mike Bostock, Mike Bostock, 35, 8, 43, 0, 41
Fri Oct 12 00:34:17 BST 2012, Mike Bostock, Mike Bostock, 2781, 3766, 6547, 0, 27
Thu Oct 11 22:50:52 BST 2012, Mike Bostock, Mike Bostock, 31, 35, 66, 0, 23
Thu Oct 11 22:39:59 BST 2012, Mike Bostock, Mike Bostock, 65, 109, 174, 0, 50
Thu Oct 11 20:32:44 BST 2012, Mike Bostock, Mike Bostock, 221, 170, 391, 0, 478
Mon Oct 08 05:00:06 BST 2012, Mike Bostock, Mike Bostock, 86, 77, 163, 0, 50
Sun Oct 07 00:40:37 BST 2012, Mike Bostock, Mike Bostock, 128, 31, 159, 0, 39
Sat Oct 06 21:19:05 BST 2012, Mike Bostock, Mike Bostock, 106, 40, 146, 0, 86
Sat Oct 06 15:11:07 BST 2012, Mike Bostock, Mike Bostock, 1, 1, 2, 0, 20
Sat Oct 06 15:08:59 BST 2012, Mike Bostock, Mike Bostock, 198, 42, 240, 0, 71
Sat Oct 06 10:17:46 BST 2012, Jason Davies, Jason Davies, 28, 42, 70, 0, 9
Sat Oct 06 10:11:47 BST 2012, Jason Davies, Jason Davies, 212, 42, 254, 0, 69
Sat Oct 06 05:33:03 BST 2012, Mike Bostock, Mike Bostock, 4, 4, 8, 0, 25
Sat Oct 06 02:46:05 BST 2012, Mike Bostock, Mike Bostock, 138, 138, 276, 0, 107
Sat Oct 06 01:15:19 BST 2012, Mike Bostock, Mike Bostock, 208, 62, 270, 0, 71
Sat Oct 06 01:05:59 BST 2012, Mike Bostock, Mike Bostock, 37, 48, 85, 0, 42
Sat Oct 06 01:05:41 BST 2012, Jason Davies, Jason Davies, 29, 28, 57, 0, 39
Sat Oct 06 00:59:50 BST 2012, Mike Bostock, Mike Bostock, 2, 8, 10, 0, 39
Sat Oct 06 00:58:59 BST 2012, Mike Bostock, Mike Bostock, 4, 5, 9, 0, 21
Sat Oct 06 00:58:19 BST 2012, Mike Bostock, Mike Bostock, 4, 75, 79, 0, 16
Sat Oct 06 00:57:39 BST 2012, Mike Bostock, Mike Bostock, 1, 4, 5, 0, 26
Sat Oct 06 00:56:49 BST 2012, Mike Bostock, Mike Bostock, 333, 355, 688, 0, 53
Sat Oct 06 00:54:21 BST 2012, Jason Davies, Jason Davies, 190, 60, 250, 0, 121
Sat Oct 06 00:46:05 BST 2012, Mike Bostock, Mike Bostock, 4, 127, 131, 0, 23
Sat Oct 06 00:44:48 BST 2012, Mike Bostock, Mike Bostock, 3, 133, 136, 0, 64
Sat Oct 06 00:35:13 BST 2012, Mike Bostock, Mike Bostock, 2325, 1359, 3684, 0, 64
Sat Oct 06 00:29:56 BST 2012, Mike Bostock, Mike Bostock, 388, 318, 706, 0, 44
Sat Oct 06 00:12:17 BST 2012, Mike Bostock, Mike Bostock, 36, 20, 56, 0, 38
Sat Oct 06 00:02:12 BST 2012, Jason Davies, Jason Davies, 19, 4, 23, 0, 23
Fri Oct 05 22:50:34 BST 2012, Mike Bostock, Mike Bostock, 14, 14, 28, 0, 95
Fri Oct 05 22:46:57 BST 2012, Mike Bostock, Mike Bostock, 2, 2, 4, 0, 17
Fri Oct 05 20:00:16 BST 2012, Mike Bostock, Mike Bostock, 311, 247, 558, 0, 2347
Fri Oct 05 07:20:56 BST 2012, Mike Bostock, Mike Bostock, 19, 10, 29, 0, 98
Thu Oct 04 18:14:16 BST 2012, Mike Bostock, Mike Bostock, 109, 90, 199, 0, 21
Thu Oct 04 18:11:24 BST 2012, Mike Bostock, Mike Bostock, 23, 35, 58, 0, 252
Thu Oct 04 10:49:15 BST 2012, Jason Davies, Jason Davies, 19, 10, 29, 0, 1141
Wed Oct 03 22:53:26 BST 2012, Mike Bostock, Mike Bostock, 82, 20, 102, 0, 103
Wed Oct 03 21:49:50 BST 2012, Jason Davies, Jason Davies, 82, 20, 102, 0, 184
Wed Oct 03 09:23:48 BST 2012, Jason Davies, Jason Davies, 5, 5, 10, 0, 270
Tue Oct 02 23:58:37 BST 2012, Jason Davies, Jason Davies, 16, 13, 29, 0, 147
Tue Oct 02 20:12:38 BST 2012, Jason Davies, Jason Davies, 6, 6, 12, 0, 50
Tue Oct 02 18:52:53 BST 2012, Jason Davies, Jason Davies, 8, 4, 12, 0, 69
Tue Oct 02 17:49:09 BST 2012, Jason Davies, Jason Davies, 10, 9, 19, 0, 114
Tue Oct 02 15:53:29 BST 2012, Jason Davies, Jason Davies, 9, 10, 19, 0, 327
Tue Oct 02 14:28:59 BST 2012, Jason Davies, Jason Davies, 11, 6, 17, 0, 92
Tue Oct 02 14:28:19 BST 2012, Mike Bostock, Mike Bostock, 12, 7, 19, 0, 111
Tue Oct 02 14:23:37 BST 2012, Jason Davies, Jason Davies, 6, 11, 17, 0, 92
Tue Oct 02 14:19:31 BST 2012, Mike Bostock, Mike Bostock, 7, 12, 19, 0, 39
Tue Oct 02 13:38:46 BST 2012, Jason Davies, Jason Davies, 4, 52, 56, 0, 19
Tue Oct 02 12:47:20 BST 2012, Jason Davies, Jason Davies, 17, 12, 29, 0, 31
Tue Oct 02 12:41:45 BST 2012, Jason Davies, Jason Davies, 4, 17, 21, 0, 19
Tue Oct 02 11:14:18 BST 2012, Jason Davies, Jason Davies, 75, 57, 132, 0, 34
Tue Oct 02 10:45:51 BST 2012, Jason Davies, Jason Davies, 614, 426, 1040, 0, 129
Mon Oct 01 23:48:51 BST 2012, Jason Davies, Jason Davies, 343, 426, 769, 0, 50
Tue Oct 02 06:45:14 BST 2012, Mike Bostock, Mike Bostock, 5, 5, 10, 0, 31
Tue Oct 02 06:39:17 BST 2012, Mike Bostock, Mike Bostock, 131, 82, 213, 0, 89
Tue Oct 02 05:58:19 BST 2012, Mike Bostock, Mike Bostock, 4, 4, 8, 0, 19
Tue Oct 02 05:50:18 BST 2012, Mike Bostock, Mike Bostock, 276, 346, 622, 0, 21
Tue Oct 02 04:39:38 BST 2012, Mike Bostock, Mike Bostock, 99, 0, 99, 0, 28
Tue Oct 02 02:20:14 BST 2012, Mike Bostock, Mike Bostock, 154, 38, 192, 0, 44
Mon Oct 01 21:57:39 BST 2012, Jason Davies, Jason Davies, 98, 19, 117, 0, 51
Sat Sep 29 23:54:07 BST 2012, Mike Bostock, Mike Bostock, 12, 8, 20, 0, 38
Sat Sep 29 23:52:37 BST 2012, Mike Bostock, Mike Bostock, 12, 12, 24, 0, 27
Sat Sep 29 23:50:01 BST 2012, Jason Davies, Jason Davies, 38, 54, 92, 0, 127
Sat Sep 29 22:09:12 BST 2012, Mike Bostock, Mike Bostock, 64, 65, 129, 0, 35
Sat Sep 29 21:55:30 BST 2012, Mike Bostock, Mike Bostock, 56, 54, 110, 0, 113
Sat Sep 29 18:20:45 BST 2012, Jason Davies, Jason Davies, 20, 23, 43, 0, 31
Sat Sep 29 15:01:39 BST 2012, Jason Davies, Jason Davies, 183, 176, 359, 0, 306
Sat Sep 29 14:40:10 BST 2012, Jason Davies, Jason Davies, 66, 66, 132, 0, 262
Sat Sep 29 14:12:42 BST 2012, Jason Davies, Jason Davies, 5, 3, 8, 0, 20
Sat Sep 29 14:09:58 BST 2012, Jason Davies, Jason Davies, 7, 11, 18, 0, 9
Sat Sep 29 12:15:17 BST 2012, Jason Davies, Jason Davies, 18, 21, 39, 0, 202
Sat Sep 29 11:24:28 BST 2012, Jason Davies, Jason Davies, 423, 308, 731, 0, 32
Sat Sep 29 00:16:53 BST 2012, Mike Bostock, Mike Bostock, 86, 55, 141, 0, 30
Fri Sep 28 23:47:13 BST 2012, Mike Bostock, Mike Bostock, 30, 3, 33, 0, 41
Fri Sep 28 23:41:55 BST 2012, Mike Bostock, Mike Bostock, 3, 0, 3, 0, 48
Fri Sep 28 23:17:54 BST 2012, Mike Bostock, Mike Bostock, 54, 53, 107, 0, 24
Fri Sep 28 20:25:29 BST 2012, Jason Davies, Jason Davies, 457, 101, 558, 0, 38
Fri Sep 28 16:53:49 BST 2012, Mike Bostock, Mike Bostock, 14, 12, 26, 0, 94
Fri Sep 28 09:15:06 BST 2012, Jason Davies, Jason Davies, 6, 6, 12, 0, 210
Fri Sep 28 08:57:03 BST 2012, Jason Davies, Jason Davies, 14, 12, 26, 0, 410
Thu Sep 27 23:29:36 BST 2012, Mike Bostock, Mike Bostock, 6, 6, 12, 0, 27
Thu Sep 27 23:21:51 BST 2012, Mike Bostock, Mike Bostock, 7, 7, 14, 0, 11
Thu Sep 27 23:14:05 BST 2012, Mike Bostock, Mike Bostock, 46, 40, 86, 0, 111
Thu Sep 27 20:39:23 BST 2012, Mike Bostock, Mike Bostock, 52, 46, 98, 0, 39
Thu Sep 27 20:13:01 BST 2012, Mike Bostock, Mike Bostock, 5, 5, 10, 0, 27
Thu Sep 27 20:11:20 BST 2012, Mike Bostock, Mike Bostock, 38, 32, 70, 0, 44
Thu Sep 27 05:19:56 BST 2012, Mike Bostock, Mike Bostock, 35, 42, 77, 0, 23
Thu Sep 27 05:01:42 BST 2012, Mike Bostock, Mike Bostock, 6, 1, 7, 0, 88
Thu Sep 27 01:33:32 BST 2012, Mike Bostock, Mike Bostock, 10, 8, 18, 0, 21
Thu Sep 27 01:25:55 BST 2012, Mike Bostock, Mike Bostock, 0, 0, 0, 0, 78
Wed Sep 26 20:23:32 BST 2012, Mike Bostock, Mike Bostock, 15, 9, 24, 0, 26
Wed Sep 26 19:51:49 BST 2012, Mike Bostock, Mike Bostock, 5, 1, 6, 0, 37
Wed Sep 26 19:40:49 BST 2012, Mike Bostock, Mike Bostock, 55, 38, 93, 0, 30
Wed Sep 26 19:34:39 BST 2012, Mike Bostock, Mike Bostock, 3, 2, 5, 0, 32
Wed Sep 26 18:30:36 BST 2012, Jason Davies, Mike Bostock, 10, 12, 22, 0, 9
Wed Sep 26 17:29:44 BST 2012, Jason Davies, Mike Bostock, 20, 9, 29, 0, 39
Wed Sep 26 18:30:36 BST 2012, Jason Davies, Jason Davies, 10, 12, 22, 0, 9
Wed Sep 26 17:29:44 BST 2012, Jason Davies, Jason Davies, 20, 9, 29, 0, 39
Wed Sep 26 15:58:33 BST 2012, Mike Bostock, Mike Bostock, 176, 76, 252, 0, 102
Wed Sep 26 14:57:55 BST 2012, Jason Davies, Jason Davies, 8, 8, 16, 0, 31
Wed Sep 26 14:47:21 BST 2012, Jason Davies, Jason Davies, 3, 3, 6, 0, 225
Wed Sep 26 14:30:40 BST 2012, Jason Davies, Jason Davies, 10, 10, 20, 0, 285
Wed Sep 26 14:16:03 BST 2012, Jason Davies, Jason Davies, 19, 34, 53, 0, 9
Wed Sep 26 14:14:13 BST 2012, Jason Davies, Jason Davies, 6, 6, 12, 0, 49
Wed Sep 26 13:35:11 BST 2012, Jason Davies, Jason Davies, 38, 25, 63, 0, 78
Wed Sep 26 12:18:04 BST 2012, Jason Davies, Jason Davies, 23, 12, 35, 0, 247
Wed Sep 26 12:07:00 BST 2012, Jason Davies, Jason Davies, 125, 59, 184, 0, 31
Wed Sep 26 10:01:32 BST 2012, Jason Davies, Jason Davies, 6, 6, 12, 0, 19
Wed Sep 26 09:59:49 BST 2012, Jason Davies, Jason Davies, 6, 6, 12, 0, 19
Wed Sep 26 09:51:47 BST 2012, Jason Davies, Jason Davies, 13, 13, 26, 0, 65
Wed Sep 26 09:29:01 BST 2012, Jason Davies, Jason Davies, 35, 36, 71, 0, 27
Wed Sep 26 09:23:58 BST 2012, Jason Davies, Jason Davies, 13, 10, 23, 0, 19
Wed Sep 26 09:14:09 BST 2012, Jason Davies, Jason Davies, 41, 18, 59, 0, 35
Wed Sep 26 01:15:11 BST 2012, Mike Bostock, Mike Bostock, 5, 9, 14, 0, 18
Wed Sep 26 00:35:02 BST 2012, Jason Davies, Jason Davies, 17, 7, 24, 0, 23
Wed Sep 26 00:24:07 BST 2012, Jason Davies, Jason Davies, 56, 6, 62, 0, 256
Tue Sep 25 23:46:29 BST 2012, Mike Bostock, Mike Bostock, 6, 6, 12, 0, 26
Tue Sep 25 23:36:07 BST 2012, Mike Bostock, Mike Bostock, 21, 21, 42, 0, 24
Tue Sep 25 23:29:29 BST 2012, Mike Bostock, Mike Bostock, 32, 30, 62, 0, 78
Tue Sep 25 23:19:50 BST 2012, Mike Bostock, Mike Bostock, 93, 24, 117, 0, 78
Tue Sep 25 23:17:17 BST 2012, Jason Davies, Jason Davies, 12, 12, 24, 0, 22
Tue Sep 25 22:57:13 BST 2012, Jason Davies, Jason Davies, 9, 8, 17, 0, 9
Tue Sep 25 22:52:25 BST 2012, Jason Davies, Jason Davies, 14, 19, 33, 0, 9
Tue Sep 25 22:45:41 BST 2012, Jason Davies, Jason Davies, 41, 56, 97, 0, 17
Tue Sep 25 22:14:32 BST 2012, Jason Davies, Jason Davies, 133, 33, 166, 0, 45
Tue Sep 25 19:31:35 BST 2012, Mike Bostock, Mike Bostock, 22, 10, 32, 0, 45
Tue Sep 25 18:41:20 BST 2012, Mike Bostock, Mike Bostock, 291, 340, 631, 0, 41
Tue Sep 25 17:59:25 BST 2012, Mike Bostock, Mike Bostock, 105, 106, 211, 0, 106
Tue Sep 25 11:49:13 BST 2012, Jason Davies, Jason Davies, 12, 32, 44, 0, 9
Mon Sep 24 18:11:40 BST 2012, Jason Davies, Jason Davies, 3, 5, 8, 0, 17
Mon Sep 24 13:41:35 BST 2012, Jason Davies, Jason Davies, 35, 14, 49, 0, 48
Mon Sep 24 10:23:59 BST 2012, Jason Davies, Jason Davies, 8, 8, 16, 0, 38
Mon Sep 24 10:22:48 BST 2012, Jason Davies, Jason Davies, 97, 97, 194, 0, 43
Mon Sep 24 03:34:32 BST 2012, Mike Bostock, Mike Bostock, 1, 25, 26, 0, 50
Mon Sep 24 03:33:04 BST 2012, Mike Bostock, Mike Bostock, 3, 3, 6, 0, 38
Mon Sep 24 01:29:25 BST 2012, Mike Bostock, Mike Bostock, 5, 5, 10, 0, 22
Mon Sep 24 01:28:20 BST 2012, Mike Bostock, Mike Bostock, 1, 2, 3, 0, 9
Mon Sep 24 01:27:46 BST 2012, Mike Bostock, Mike Bostock, 18, 32, 50, 0, 32
Mon Sep 24 01:05:12 BST 2012, Mike Bostock, Mike Bostock, 63, 65, 128, 0, 28
Mon Sep 24 00:49:11 BST 2012, Mike Bostock, Mike Bostock, 860, 782, 1642, 0, 101
Sun Sep 23 00:08:27 BST 2012, Mike Bostock, Mike Bostock, 25, 13, 38, 0, 50
Sun Sep 23 00:03:55 BST 2012, Mike Bostock, Mike Bostock, 13, 20, 33, 0, 102
Thu Sep 20 05:29:46 BST 2012, Mike Bostock, Mike Bostock, 12, 0, 12, 0, 31
Thu Sep 20 02:54:36 BST 2012, Mike Bostock, Mike Bostock, 6, 117, 123, 3, 49
Thu Sep 20 02:37:23 BST 2012, Mike Bostock, Mike Bostock, 117, 6, 123, 0, 242
Thu Sep 20 00:39:53 BST 2012, Mike Bostock, Mike Bostock, 14, 18, 32, 0, 17
Thu Sep 20 00:34:15 BST 2012, Mike Bostock, Mike Bostock, 6, 9, 15, 0, 40
Wed Sep 19 23:23:43 BST 2012, Mike Bostock, Mike Bostock, 37, 48, 85, 0, 105
Wed Sep 19 21:48:27 BST 2012, Mike Bostock, Mike Bostock, 5, 6, 11, 0, 29
Wed Sep 19 21:48:06 BST 2012, Mike Bostock, Mike Bostock, 1, 3, 4, 0, 16
Wed Sep 19 21:47:37 BST 2012, Mike Bostock, Mike Bostock, 1, 1, 2, 0, 21
Wed Sep 19 21:45:44 BST 2012, Mike Bostock, Mike Bostock, 11, 4, 15, 0, 82
Wed Sep 19 21:08:57 BST 2012, Mike Bostock, Mike Bostock, 5, 7, 12, 0, 95
Wed Sep 19 20:59:06 BST 2012, Mike Bostock, Mike Bostock, 72, 72, 144, 0, 47
Wed Sep 19 20:11:50 BST 2012, Mike Bostock, Mike Bostock, 12, 6, 18, 0, 31
Wed Sep 19 19:21:32 BST 2012, Mike Bostock, Mike Bostock, 24, 24, 48, 0, 113
Wed Sep 19 19:09:26 BST 2012, Mike Bostock, Mike Bostock, 101, 92, 193, 0, 49
Wed Sep 19 18:39:24 BST 2012, Mike Bostock, Mike Bostock, 5, 5, 10, 0, 12
Wed Sep 19 00:06:25 BST 2012, Mike Bostock, Mike Bostock, 6, 6, 12, 0, 101
Wed Sep 19 00:03:04 BST 2012, Mike Bostock, Mike Bostock, 5, 5, 10, 0, 41
Tue Sep 18 23:49:03 BST 2012, Mike Bostock, Mike Bostock, 194, 89, 283, 0, 419
Tue Sep 18 04:34:08 BST 2012, Tim Branyen, Tim Branyen, 6, 0, 6, 0, 37
Mon Sep 17 22:26:54 BST 2012, Tim Branyen, Tim Branyen, 6, 0, 6, 0, 15
Fri Sep 14 20:48:53 BST 2012, Mike Bostock, Mike Bostock, 6, 6, 12, 0, 37
Fri Sep 14 20:38:35 BST 2012, Mike Bostock, Mike Bostock, 18, 0, 18, 0, 36
Thu Sep 06 15:53:18 BST 2012, Jason Davies, Jason Davies, 26, 24, 50, 0, 39
Wed Sep 05 22:16:40 BST 2012, Ger Hobbelt, Ger Hobbelt, 2, 2, 4, 0, 109
Wed Sep 05 22:10:29 BST 2012, Ger Hobbelt, Ger Hobbelt, 5, 3, 8, 0, 217
Wed Sep 05 15:33:09 BST 2012, Jason Davies, Jason Davies, 4, 4, 8, 0, 103
Tue Sep 04 03:19:37 BST 2012, Mike Bostock, Mike Bostock, 6118, 6103, 12221, 0, 21
Tue Sep 04 03:18:32 BST 2012, Mike Bostock, Mike Bostock, 9, 5, 14, 0, 37
Tue Sep 04 03:08:11 BST 2012, Mike Bostock, Mike Bostock, 6015, 6015, 12030, 0, 68
Tue Sep 04 03:06:22 BST 2012, Mike Bostock, Mike Bostock, 9, 4, 13, 0, 51
Tue Sep 04 03:05:49 BST 2012, Mike Bostock, Mike Bostock, 5, 5, 10, 0, 70
Tue Sep 04 03:04:34 BST 2012, Mike Bostock, Mike Bostock, 3, 6, 9, 0, 73
Tue Sep 04 03:03:51 BST 2012, Mike Bostock, Mike Bostock, 5, 5, 10, 0, 73
Tue Sep 04 02:56:32 BST 2012, Mike Bostock, Mike Bostock, 15, 9, 24, 0, 36
Fri Aug 31 21:11:34 BST 2012, Mike Bostock, Mike Bostock, 71, 68, 139, 0, 20
Tue Aug 21 12:04:37 BST 2012, Jason Davies, Jason Davies, 5, 5, 10, 0, 107
Mon Aug 20 23:25:10 BST 2012, Jason Davies, Jason Davies, 0, 1, 1, 0, 53
Mon Aug 20 22:15:08 BST 2012, Jason Davies, Jason Davies, 3, 5, 8, 0, 235
Thu Aug 16 22:40:48 BST 2012, Jason Davies, Jason Davies, 7, 7, 14, 0, 19
Thu Aug 16 21:26:14 BST 2012, Mike Bostock, Mike Bostock, 11, 6, 17, 0, 39
Thu Aug 16 08:32:47 BST 2012, Jason Davies, Jason Davies, 19, 5, 24, 0, 35
Wed Aug 15 23:58:58 BST 2012, Jason Davies, Jason Davies, 48, 7, 55, 0, 32
Wed Aug 15 23:21:19 BST 2012, Jason Davies, Jason Davies, 95, 39, 134, 0, 199
Wed Aug 15 16:13:01 BST 2012, Jason Davies, Jason Davies, 8, 8, 16, 0, 113
Wed Aug 15 16:06:27 BST 2012, Jason Davies, Jason Davies, 69, 143, 212, 0, 67
Wed Aug 15 15:43:09 BST 2012, Jason Davies, Jason Davies, 139, 4, 143, 0, 112
Mon Aug 13 21:34:41 BST 2012, Jason Davies, Jason Davies, 16, 23, 39, 0, 9
Mon Aug 13 21:31:55 BST 2012, Jason Davies, Jason Davies, 37, 32, 69, 0, 117
Mon Aug 13 21:23:49 BST 2012, Jason Davies, Jason Davies, 22, 20, 42, 0, 48
Mon Aug 13 21:10:43 BST 2012, Jason Davies, Jason Davies, 6, 7, 13, 0, 21
Mon Aug 13 19:55:54 BST 2012, Jason Davies, Jason Davies, 93, 64, 157, 0, 228
Sun Aug 12 23:05:41 BST 2012, Jason Davies, Jason Davies, 6016, 6016, 12032, 0, 109
Sun Aug 12 22:17:50 BST 2012, Jason Davies, Jason Davies, 4, 13, 17, 0, 46
Sun Aug 12 18:45:27 BST 2012, Jason Davies, Jason Davies, 5, 3, 8, 0, 9
Sun Aug 12 18:45:12 BST 2012, Jason Davies, Jason Davies, 2, 1, 3, 0, 44
Sun Aug 12 18:34:05 BST 2012, Jason Davies, Jason Davies, 49, 41, 90, 0, 197
Sun Aug 12 16:56:02 BST 2012, Mike Bostock, Mike Bostock, 14, 0, 14, 0, 89
Sun Aug 12 10:22:50 BST 2012, Jason Davies, Jason Davies, 14, 0, 14, 0, 36
Fri Aug 10 04:11:48 BST 2012, Mike Bostock, Mike Bostock, 1975, 976, 2951, 0, 21
Fri Aug 10 02:46:28 BST 2012, Mike Bostock, Mike Bostock, 5, 5, 10, 0, 63
Thu Aug 09 05:22:21 BST 2012, Mike Bostock, Mike Bostock, 434, 6, 440, 0, 73
Thu Aug 09 04:40:36 BST 2012, Mike Bostock, Mike Bostock, 78, 11, 89, 0, 48
Thu Aug 09 04:33:23 BST 2012, Mike Bostock, Mike Bostock, 107, 4, 111, 0, 35
Thu Aug 09 03:12:43 BST 2012, Mike Bostock, Mike Bostock, 69, 44, 113, 1, 38
Thu Aug 09 02:08:47 BST 2012, Mike Bostock, Mike Bostock, 527, 216, 743, 0, 124
Thu Aug 09 01:53:46 BST 2012, Mike Bostock, Mike Bostock, 60, 66, 126, 0, 136
Thu Aug 09 01:36:40 BST 2012, Mike Bostock, Mike Bostock, 76, 59, 135, 0, 62
Thu Aug 09 01:36:01 BST 2012, Mike Bostock, Mike Bostock, 392, 241, 633, 0, 76
Thu Aug 09 01:35:19 BST 2012, Mike Bostock, Mike Bostock, 48, 31, 79, 0, 70
Thu Aug 09 01:34:25 BST 2012, Mike Bostock, Mike Bostock, 50, 37, 87, 0, 104
Thu Aug 09 01:32:32 BST 2012, Mike Bostock, Mike Bostock, 41, 201, 242, 0, 109
Thu Aug 09 01:30:36 BST 2012, Mike Bostock, Mike Bostock, 67, 96, 163, 0, 45
Tue Aug 07 20:35:10 BST 2012, Mike Bostock, Mike Bostock, 46, 55, 101, 2, 38
Tue Aug 07 20:19:18 BST 2012, Mike Bostock, Mike Bostock, 75, 95, 170, 0, 214
Mon Aug 06 00:39:11 BST 2012, Mike Bostock, Mike Bostock, 44, 5, 49, 0, 40
Mon Aug 06 00:29:04 BST 2012, Mike Bostock, Mike Bostock, 87, 47, 134, 0, 31
Sun Aug 05 23:52:10 BST 2012, Mike Bostock, Mike Bostock, 27, 141, 168, 0, 46
Sun Aug 05 22:54:02 BST 2012, Mike Bostock, Mike Bostock, 241, 135, 376, 0, 36
Sun Aug 05 18:42:28 BST 2012, Mike Bostock, Mike Bostock, 24, 22, 46, 0, 39
Sun Aug 05 18:38:00 BST 2012, Mike Bostock, Mike Bostock, 42, 35, 77, 0, 39
Sun Aug 05 18:09:16 BST 2012, Mike Bostock, Mike Bostock, 31, 28, 59, 0, 42
Mon Aug 29 01:07:55 BST 2011, Mike Bostock, Mike Bostock, 81, 12, 93, 0, 37
Mon Aug 29 00:59:40 BST 2011, Mike Bostock, Mike Bostock, 106, 16, 122, 0, 34
Mon Aug 29 00:25:48 BST 2011, Mike Bostock, Mike Bostock, 81, 19, 100, 0, 33
Sat Aug 04 20:11:35 BST 2012, Mike Bostock, Mike Bostock, 23, 181, 204, 0, 379
Sat Aug 04 20:02:17 BST 2012, Mike Bostock, Mike Bostock, 22, 18, 40, 0, 63
Fri Aug 03 01:50:14 BST 2012, Mike Bostock, Mike Bostock, 38, 38, 76, 0, 35
Fri Aug 03 01:48:26 BST 2012, Mike Bostock, Mike Bostock, 38, 38, 76, 1, 196
Wed Aug 01 22:31:00 BST 2012, Mike Bostock, Mike Bostock, 40, 24, 64, 0, 45
Wed Aug 01 22:29:21 BST 2012, Mike Bostock, Mike Bostock, 40, 0, 40, 0, 39
Wed Aug 01 13:31:48 BST 2012, Jason Davies, Jason Davies, 1, 1, 2, 0, 46
Wed Aug 01 13:07:13 BST 2012, Jason Davies, Jason Davies, 28, 22, 50, 0, 343
Wed Aug 01 03:38:36 BST 2012, Mike Bostock, Mike Bostock, 40, 24, 64, 0, 113
Tue Jul 31 22:59:49 BST 2012, Mike Bostock, Mike Bostock, 10319, 12496, 22815, 0, 20
Tue Jul 31 22:54:04 BST 2012, Mike Bostock, Mike Bostock, 1, 1, 2, 0, 179
Tue Jul 31 22:46:28 BST 2012, Mike Bostock, Mike Bostock, 177, 70, 247, 0, 149
Tue Jul 31 21:56:18 BST 2012, Mike Bostock, Mike Bostock, 12, 27, 39, 0, 280
Tue Jul 31 21:30:39 BST 2012, Mike Bostock, Mike Bostock, 71, 5, 76, 0, 73
Tue Jul 31 21:29:20 BST 2012, Mike Bostock, Mike Bostock, 3, 5, 8, 0, 27
Tue Jul 31 21:20:26 BST 2012, Mike Bostock, Mike Bostock, 18, 31, 49, 0, 75
Tue Jul 31 16:15:30 BST 2012, Jason Davies, Jason Davies, 11, 14, 25, 0, 93
Tue Jul 31 14:51:49 BST 2012, Jason Davies, Jason Davies, 53, 10, 63, 0, 47
Tue Jul 31 14:00:26 BST 2012, Jason Davies, Jason Davies, 71, 5, 76, 0, 37
Tue Jul 31 13:38:41 BST 2012, Jason Davies, Jason Davies, 94, 88, 182, 0, 79
Tue Jul 31 13:01:45 BST 2012, Jason Davies, Jason Davies, 74, 37, 111, 0, 271
Tue Jul 31 11:43:35 BST 2012, Jason Davies, Jason Davies, 5, 5, 10, 0, 43
Tue Jul 31 08:38:13 BST 2012, Mike Bostock, Mike Bostock, 22, 11, 33, 0, 40
Tue Jul 31 08:30:31 BST 2012, Mike Bostock, Mike Bostock, 14, 5, 19, 0, 53
Tue Jul 31 08:27:14 BST 2012, Mike Bostock, Mike Bostock, 79, 79, 158, 0, 41
Tue Jul 31 07:43:35 BST 2012, Mike Bostock, Mike Bostock, 7, 7, 14, 0, 38
Tue Jul 31 07:39:40 BST 2012, Mike Bostock, Mike Bostock, 3185, 3215, 6400, 0, 41
Tue Jul 31 03:43:47 BST 2012, Mike Bostock, Mike Bostock, 6651, 9256, 15907, 0, 34
Tue Jul 31 03:42:32 BST 2012, Mike Bostock, Mike Bostock, 222, 205, 427, 0, 80
Tue Jul 31 02:54:22 BST 2012, Mike Bostock, Mike Bostock, 207, 103, 310, 0, 70
Tue Jul 31 02:20:11 BST 2012, Mike Bostock, Mike Bostock, 13, 9, 22, 0, 75
Tue Jul 31 02:18:48 BST 2012, Mike Bostock, Mike Bostock, 48, 24, 72, 0, 44
Tue Jul 31 02:18:04 BST 2012, Mike Bostock, Mike Bostock, 20, 14, 34, 0, 67
Tue Jul 31 02:17:15 BST 2012, Mike Bostock, Mike Bostock, 6, 16, 22, 0, 53
Tue Jul 31 02:16:33 BST 2012, Mike Bostock, Mike Bostock, 11, 7, 18, 0, 79
Tue Jul 31 02:13:32 BST 2012, Mike Bostock, Mike Bostock, 25, 3, 28, 0, 79
Tue Jul 31 02:12:37 BST 2012, Mike Bostock, Mike Bostock, 128, 4, 132, 0, 78
Tue Jul 31 02:11:07 BST 2012, Mike Bostock, Mike Bostock, 16, 16, 32, 0, 69
Tue Jul 31 01:05:24 BST 2012, Mike Bostock, Mike Bostock, 3185, 3215, 6400, 0, 81
Thu Jul 26 01:26:06 BST 2012, Steven Noble, Steven Noble, 4, 4, 8, 0, 25
Thu Jul 26 01:25:03 BST 2012, Steven Noble, Steven Noble, 5, 3, 8, 0, 77
Thu Jul 26 00:24:26 BST 2012, Steven Noble, Steven Noble, 1, 1, 2, 0, 166
Thu Jul 26 00:23:22 BST 2012, Steven Noble, Steven Noble, 1, 1, 2, 0, 59
Wed Jul 25 21:35:03 BST 2012, Jason Davies, Jason Davies, 18, 31, 49, 0, 328
Wed Jul 25 19:34:38 BST 2012, Jason Davies, Jason Davies, 128, 21, 149, 0, 60
Wed Jul 25 18:22:03 BST 2012, Jason Davies, Jason Davies, 5, 5, 10, 0, 69
Wed Jul 25 18:18:44 BST 2012, Jason Davies, Jason Davies, 4, 0, 4, 0, 17
Wed Jul 25 15:26:05 BST 2012, Jason Davies, Jason Davies, 8, 8, 16, 0, 39
Wed Jul 25 13:46:20 BST 2012, Jason Davies, Jason Davies, 16, 16, 32, 0, 103
Wed Jul 25 13:00:40 BST 2012, Jason Davies, Jason Davies, 12, 12, 24, 0, 82
Wed Jul 25 10:58:06 BST 2012, Jason Davies, Jason Davies, 2, 2, 4, 0, 22
Wed Jul 25 10:02:49 BST 2012, Jason Davies, Jason Davies, 21, 8, 29, 0, 73
Tue Jul 24 21:25:55 BST 2012, Jason Davies, Jason Davies, 70, 74, 144, 0, 47
Tue Jul 24 21:17:11 BST 2012, Jason Davies, Jason Davies, 238, 204, 442, 0, 85
Tue Jul 24 19:48:26 BST 2012, Jason Davies, Jason Davies, 84, 84, 168, 0, 45
Tue Jul 24 18:38:05 BST 2012, Jason Davies, Jason Davies, 131, 57, 188, 0, 552
Mon Jul 23 18:34:39 BST 2012, Jason Davies, Jason Davies, 25, 3, 28, 0, 49
Mon Jul 23 16:08:26 BST 2012, Jason Davies, Jason Davies, 16, 11, 27, 0, 436
Sat Jul 21 02:00:10 BST 2012, Nathan Vander Wilt, Nathan Vander Wilt, 11, 9, 20, 0, 82
Thu Jul 19 19:07:36 BST 2012, Mike Bostock, Mike Bostock, 6579, 9178, 15757, 0, 163
Thu Jul 19 19:02:35 BST 2012, Mike Bostock, Mike Bostock, 2, 1, 3, 0, 19
Tue Jul 17 22:00:08 BST 2012, Mike Bostock, Mike Bostock, 18, 18, 36, 0, 81
Tue Jul 17 21:45:34 BST 2012, Mike Bostock, Mike Bostock, 31, 7, 38, 0, 95
Tue Jul 17 21:45:18 BST 2012, Mike Bostock, Mike Bostock, 2, 1, 3, 0, 19
Fri Jul 13 17:02:12 BST 2012, Mike Bostock, Mike Bostock, 5, 2, 7, 0, 24
Tue Jul 10 16:37:52 BST 2012, Jason Davies, Jason Davies, 18, 18, 36, 0, 172
Thu Jul 05 08:42:36 BST 2012, Jason Davies, Jason Davies, 20, 14, 34, 0, 368
Wed Jul 04 19:22:08 BST 2012, Mike Bostock, Mike Bostock, 15, 5, 20, 0, 44
Wed Jul 04 19:21:05 BST 2012, Mike Bostock, Mike Bostock, 6, 16, 22, 0, 28
Tue Jul 03 02:08:52 BST 2012, Mike Bostock, Mike Bostock, 328, 243, 571, 0, 20
Tue Jul 03 02:06:53 BST 2012, Mike Bostock, Mike Bostock, 54, 36, 90, 0, 45
Tue Jul 03 02:06:23 BST 2012, Mike Bostock, Mike Bostock, 64, 86, 150, 0, 41
Tue Jul 03 02:05:51 BST 2012, Mike Bostock, Mike Bostock, 22, 20, 42, 0, 45
Tue Jul 03 01:42:23 BST 2012, Mike Bostock, Mike Bostock, 11, 6, 17, 0, 175
Tue Jul 03 00:58:54 BST 2012, Mike Bostock, Mike Bostock, 140, 82, 222, 0, 178
Mon Jul 02 18:59:06 BST 2012, Mike Bostock, Mike Bostock, 16, 36, 52, 0, 23
Mon Jul 02 17:02:52 BST 2012, Jason Davies, Jason Davies, 34, 0, 34, 0, 38
Mon Jul 02 16:53:51 BST 2012, Jason Davies, Jason Davies, 16, 6, 22, 0, 45
Mon Jul 02 09:19:39 BST 2012, Jason Davies, Jason Davies, 8, 8, 16, 0, 190
Sat Jun 30 18:35:58 BST 2012, Mike Bostock, Mike Bostock, 59, 54, 113, 0, 173
Fri Jun 29 04:41:33 BST 2012, Mike Bostock, Mike Bostock, 48, 28, 76, 0, 142
Fri Jun 29 01:43:26 BST 2012, Mike Bostock, Mike Bostock, 22, 20, 42, 0, 60
Thu Jun 28 20:57:36 BST 2012, Mike Bostock, Mike Bostock, 406, 253, 659, 1, 186
Thu Jun 28 20:21:32 BST 2012, Mike Bostock, Mike Bostock, 64, 86, 150, 0, 165
Thu Jun 28 04:03:08 BST 2012, Mike Bostock, Mike Bostock, 80, 64, 144, 0, 531
Mon Jun 25 21:03:55 BST 2012, Mike Bostock, Mike Bostock, 54, 36, 90, 0, 276
Sun Jun 24 19:03:14 BST 2012, Mike Bostock, Mike Bostock, 194, 75, 269, 0, 20
Sun Jun 24 18:59:40 BST 2012, Mike Bostock, Mike Bostock, 132, 3, 135, 0, 48
Sun Jun 24 18:59:06 BST 2012, Mike Bostock, Mike Bostock, 8, 12, 20, 0, 48
Sun Jun 24 18:43:13 BST 2012, Mike Bostock, Mike Bostock, 134, 7, 141, 0, 43
Sun Jun 24 18:00:28 BST 2012, Mike Bostock, Mike Bostock, 3, 3, 6, 0, 25
Sun Jun 24 17:59:41 BST 2012, Mike Bostock, Mike Bostock, 5, 7, 12, 0, 20
Sun Jun 24 17:22:23 BST 2012, Mike Bostock, Mike Bostock, 58, 64, 122, 0, 845
Fri Jun 22 01:37:34 BST 2012, Mike Bostock, Mike Bostock, 84, 53, 137, 0, 49
Fri Jun 22 01:35:23 BST 2012, Mike Bostock, Mike Bostock, 7, 5, 12, 0, 45
Wed Jun 20 23:14:10 BST 2012, Dirk Bergstrom, Dirk Bergstrom, 1, 3, 4, 0, 156
Tue Jun 19 17:15:34 BST 2012, Mike Bostock, Mike Bostock, 23, 19, 42, 0, 20
Tue Jun 19 17:12:56 BST 2012, Mike Bostock, Mike Bostock, 5, 5, 10, 0, 64
Tue Jun 19 17:11:53 BST 2012, Mike Bostock, Mike Bostock, 5, 5, 10, 0, 66
Tue Jun 19 16:50:37 BST 2012, Mike Bostock, Mike Bostock, 13, 9, 22, 0, 78
Thu Jun 14 17:34:45 BST 2012, Mike Bostock, Mike Bostock, 67, 40, 107, 0, 20
Thu Jun 14 17:33:49 BST 2012, Mike Bostock, Mike Bostock, 25, 9, 34, 0, 39
Tue May 29 23:16:22 BST 2012, Mike Bostock, Mike Bostock, 25, 9, 34, 0, 239
Thu Jun 14 17:29:39 BST 2012, Mike Bostock, Mike Bostock, 6, 3, 9, 0, 62
Thu Jun 14 17:26:57 BST 2012, Mike Bostock, Mike Bostock, 38, 30, 68, 0, 74
Fri Jun 01 04:26:45 BST 2012, Brandon Liu, Brandon Liu, 9, 6, 15, 0, 79
Tue May 29 14:43:52 BST 2012, George Adams, George Adams, 1, 1, 2, 0, 376
Sun May 27 16:13:10 BST 2012, Jason Davies, Jason Davies, 3, 3, 6, 0, 23
Sun May 27 15:25:08 BST 2012, Jason Davies, Jason Davies, 10, 6, 16, 0, 292
Wed May 16 17:57:18 BST 2012, Mike Bostock, Mike Bostock, 22, 17, 39, 0, 20
Wed May 16 17:56:18 BST 2012, Mike Bostock, Mike Bostock, 11, 10, 21, 0, 48
Fri May 11 14:49:48 BST 2012, Jason Davies, Jason Davies, 6, 4, 10, 0, 37
Fri May 11 09:51:12 BST 2012, Jason Davies, Jason Davies, 5, 3, 8, 0, 43
Thu May 10 23:23:31 BST 2012, Jason Davies, Jason Davies, 2, 2, 4, 0, 42
Wed May 09 22:04:00 BST 2012, Jason Davies, Jason Davies, 38, 30, 68, 0, 222
Wed May 09 18:29:22 BST 2012, Mike Bostock, Mike Bostock, 2, 1, 3, 0, 41
Fri May 04 07:41:25 BST 2012, Jason Davies, Jason Davies, 6, 40, 46, 0, 520
Thu May 03 15:59:42 BST 2012, Jason Davies, Jason Davies, 38, 4, 42, 0, 311
Tue May 01 16:50:25 BST 2012, Mike Bostock, Mike Bostock, 2, 2, 4, 0, 20
Tue May 01 15:35:58 BST 2012, Lachèze Alexandre, Lachèze Alexandre, 3, 0, 3, 0, 28
Thu Apr 26 17:31:22 BST 2012, webmonarch, webmonarch, 1, 1, 2, 0, 30
Thu Apr 26 17:27:35 BST 2012, webmonarch, webmonarch, 0, 4, 4, 0, 29
Thu Apr 26 07:01:47 BST 2012, webmonarch, webmonarch, 1, 1, 2, 0, 89
Thu Apr 26 06:18:02 BST 2012, Mike Bostock, Mike Bostock, 11, 10, 21, 0, 110
Thu Apr 26 05:51:18 BST 2012, webmonarch, webmonarch, 1, 3, 4, 0, 86
Thu Apr 26 02:59:42 BST 2012, webmonarch, webmonarch, 2, 0, 2, 0, 81
Thu Apr 26 02:39:03 BST 2012, webmonarch, webmonarch, 1, 1, 2, 0, 43
Thu Apr 26 00:31:48 BST 2012, webmonarch, webmonarch, 1, 1, 2, 0, 92
Wed Apr 25 02:27:23 BST 2012, Mike Bostock, Mike Bostock, 3, 53, 56, 0, 39
Thu Apr 19 02:30:22 BST 2012, Mike Bostock, Mike Bostock, 6, 10, 16, 0, 85
Sun Apr 15 22:42:51 BST 2012, Mike Bostock, Mike Bostock, 1794, 1176, 2970, 0, 20
Sun Apr 15 22:39:54 BST 2012, Mike Bostock, Mike Bostock, 3, 5, 8, 0, 180
Sun Apr 15 22:30:52 BST 2012, Mike Bostock, Mike Bostock, 17, 13, 30, 0, 27
Sun Apr 15 22:13:43 BST 2012, Mike Bostock, Mike Bostock, 880, 713, 1593, 0, 89
Sun Apr 15 22:12:37 BST 2012, Mike Bostock, Mike Bostock, 2, 7, 9, 0, 68
Sun Apr 15 19:59:56 BST 2012, Jason Davies, Jason Davies, 2, 7, 9, 0, 63
Sun Apr 15 19:45:57 BST 2012, Jason Davies, Jason Davies, 3, 3, 6, 0, 158
Sat Apr 07 05:36:20 BST 2012, Kristofer Monisit, Kristofer Monisit, 11, 4, 15, 0, 29
Sat Apr 07 05:34:26 BST 2012, Kristofer Monisit, Kristofer Monisit, 5, 5, 10, 0, 32
Sat Apr 07 05:33:34 BST 2012, Kristofer Monisit, Kristofer Monisit, 16, 13, 29, 0, 35
Sat Apr 07 05:30:46 BST 2012, Kristofer Monisit, Kristofer Monisit, 10, 10, 20, 0, 33
Sat Apr 07 05:26:22 BST 2012, Kristofer Monisit, Kristofer Monisit, 23, 23, 46, 0, 30
Sat Apr 07 03:03:58 BST 2012, Kristofer Monisit, Kristofer Monisit, 6, 6, 12, 0, 34
Sat Apr 07 02:59:56 BST 2012, Kristofer Monisit, Kristofer Monisit, 24, 16, 40, 0, 38
Sat Apr 07 02:48:52 BST 2012, Kristofer Monisit, Kristofer Monisit, 22, 22, 44, 0, 32
Sat Apr 07 02:39:35 BST 2012, Kristofer Monisit, Kristofer Monisit, 7, 2, 9, 0, 30
Sat Apr 07 02:35:35 BST 2012, Kristofer Monisit, Kristofer Monisit, 9, 9, 18, 0, 31
Sat Apr 07 02:33:30 BST 2012, Kristofer Monisit, Kristofer Monisit, 17, 10, 27, 0, 29
Sat Apr 07 02:26:49 BST 2012, Kristofer Monisit, Kristofer Monisit, 55, 51, 106, 0, 33
Sat Apr 07 02:21:04 BST 2012, Kristofer Monisit, Kristofer Monisit, 14, 8, 22, 0, 31
Sat Apr 07 02:17:27 BST 2012, Kristofer Monisit, Kristofer Monisit, 8, 8, 16, 0, 33
Sat Apr 07 02:15:43 BST 2012, Kristofer Monisit, Kristofer Monisit, 9, 9, 18, 0, 27
Fri Apr 06 17:42:24 BST 2012, Kristofer Monisit, Kristofer Monisit, 12, 8, 20, 0, 35
Fri Apr 06 17:39:49 BST 2012, Kristofer Monisit, Kristofer Monisit, 16, 15, 31, 0, 29
Fri Apr 06 17:37:01 BST 2012, Kristofer Monisit, Kristofer Monisit, 40, 30, 70, 0, 34
Fri Apr 06 17:30:29 BST 2012, Kristofer Monisit, Kristofer Monisit, 11, 9, 20, 0, 33
Fri Apr 06 17:26:45 BST 2012, Kristofer Monisit, Kristofer Monisit, 5, 5, 10, 0, 29
Fri Apr 06 17:25:31 BST 2012, Kristofer Monisit, Kristofer Monisit, 6, 6, 12, 0, 30
Fri Apr 06 17:22:20 BST 2012, Kristofer Monisit, Kristofer Monisit, 5, 5, 10, 0, 31
Fri Apr 06 17:20:49 BST 2012, Kristofer Monisit, Kristofer Monisit, 16, 10, 26, 0, 34
Fri Apr 06 17:17:09 BST 2012, Kristofer Monisit, Kristofer Monisit, 16, 10, 26, 0, 28
Fri Apr 06 17:10:40 BST 2012, Kristofer Monisit, Kristofer Monisit, 6, 6, 12, 0, 29
Fri Apr 06 17:09:32 BST 2012, Kristofer Monisit, Kristofer Monisit, 23, 23, 46, 0, 32
Fri Apr 06 17:07:16 BST 2012, Kristofer Monisit, Kristofer Monisit, 18, 6, 24, 0, 30
Fri Apr 06 12:19:37 BST 2012, Kristofer Monisit, Kristofer Monisit, 4, 4, 8, 0, 34
Fri Apr 06 11:54:10 BST 2012, Kristofer Monisit, Kristofer Monisit, 57, 53, 110, 0, 31
Fri Apr 06 11:49:52 BST 2012, Kristofer Monisit, Kristofer Monisit, 9, 9, 18, 0, 29
Fri Apr 06 11:48:58 BST 2012, Kristofer Monisit, Kristofer Monisit, 19, 14, 33, 0, 28
Fri Apr 06 11:47:11 BST 2012, Kristofer Monisit, Kristofer Monisit, 13, 13, 26, 0, 30
Fri Apr 06 05:42:30 BST 2012, Kristofer Monisit, Kristofer Monisit, 254, 215, 469, 0, 25
Fri Apr 06 05:34:54 BST 2012, Kristofer Monisit, Kristofer Monisit, 5, 5, 10, 0, 33
Fri Apr 06 05:30:22 BST 2012, Kristofer Monisit, Kristofer Monisit, 4, 4, 8, 0, 31
Fri Apr 06 05:23:25 BST 2012, Kristofer Monisit, Kristofer Monisit, 21, 21, 42, 0, 32
Fri Apr 06 05:19:31 BST 2012, Kristofer Monisit, Kristofer Monisit, 10, 10, 20, 0, 32
Fri Apr 06 05:16:33 BST 2012, Kristofer Monisit, Kristofer Monisit, 10, 10, 20, 0, 30
Fri Apr 06 05:00:55 BST 2012, Kristofer Monisit, Kristofer Monisit, 19, 19, 38, 0, 31
Fri Apr 06 04:46:26 BST 2012, Kristofer Monisit, Kristofer Monisit, 53, 51, 104, 0, 33
Fri Apr 06 03:38:33 BST 2012, Kristofer Monisit, Kristofer Monisit, 7, 7, 14, 0, 31
Fri Apr 06 03:33:12 BST 2012, Kristofer Monisit, Kristofer Monisit, 9, 9, 18, 0, 31
Fri Apr 06 03:17:20 BST 2012, Kristofer Monisit, Kristofer Monisit, 55, 48, 103, 0, 31
Fri Apr 06 03:14:06 BST 2012, Kristofer Monisit, Kristofer Monisit, 8, 8, 16, 0, 28
Fri Apr 06 02:49:16 BST 2012, Kristofer Monisit, Kristofer Monisit, 30, 20, 50, 0, 43
Thu Apr 05 16:21:17 BST 2012, Kristofer Monisit, Kristofer Monisit, 90, 71, 161, 0, 44
Wed Apr 04 18:44:22 BST 2012, Mike Bostock, Mike Bostock, 549, 464, 1013, 0, 53
Wed Apr 04 16:12:12 BST 2012, Kristofer Monisit, Kristofer Monisit, 165, 0, 165, 0, 41
Wed Apr 04 15:30:48 BST 2012, Kristofer Monisit, Kristofer Monisit, 97, 0, 97, 0, 434
Tue Apr 03 16:48:50 BST 2012, Mike Bostock, Mike Bostock, 10, 10, 20, 0, 70
Tue Apr 03 14:00:44 BST 2012, Jason Davies, Jason Davies, 5, 5, 10, 0, 39
Tue Apr 03 13:59:38 BST 2012, Jason Davies, Jason Davies, 8, 8, 16, 0, 28
Fri Mar 30 06:11:25 BST 2012, Mike Bostock, Mike Bostock, 3, 2, 5, 0, 20
Fri Mar 30 06:09:37 BST 2012, Mike Bostock, Mike Bostock, 2, 1, 3, 0, 65
Fri Mar 30 06:07:11 BST 2012, Mike Bostock, Mike Bostock, 19, 15, 34, 0, 36
Fri Mar 30 06:01:48 BST 2012, Mike Bostock, Mike Bostock, 8, 2, 10, 0, 68
Fri Mar 30 06:00:15 BST 2012, Mike Bostock, Mike Bostock, 3, 2, 5, 0, 36
Fri Mar 30 05:57:47 BST 2012, Mike Bostock, Mike Bostock, 5, 2, 7, 0, 71
Fri Mar 30 05:57:28 BST 2012, Mike Bostock, Mike Bostock, 5, 3, 8, 0, 78
Fri Mar 30 05:56:51 BST 2012, Mike Bostock, Mike Bostock, 6, 2, 8, 0, 78
Fri Mar 30 05:55:56 BST 2012, Mike Bostock, Mike Bostock, 292, 220, 512, 0, 44
Fri Mar 30 05:55:27 BST 2012, Mike Bostock, Mike Bostock, 12, 5, 17, 0, 54
Fri Mar 30 05:55:04 BST 2012, Mike Bostock, Mike Bostock, 5, 5, 10, 0, 53
Fri Mar 30 02:00:27 BST 2012, Michael Meisel, Michael Meisel, 1, 1, 2, 0, 66
Wed Mar 28 17:43:18 BST 2012, Mike Bostock, Mike Bostock, 5, 5, 10, 0, 47
Fri Mar 23 17:18:45 GMT 2012, David Poncelow, David Poncelow, 250, 0, 250, 0, 46
Fri Mar 23 13:22:07 GMT 2012, Jon Seymour, Jon Seymour, 4, 0, 4, 0, 121
Fri Mar 23 12:30:08 GMT 2012, Jon Seymour, Jon Seymour, 4, 2, 6, 0, 625
Fri Mar 23 12:06:03 GMT 2012, Jason Davies, Jason Davies, 11, 5, 16, 0, 104
Tue Mar 20 18:48:13 GMT 2012, Michael Meisel, Michael Meisel, 1, 0, 1, 0, 56
Mon Mar 19 22:49:09 GMT 2012, Mike Bostock, Mike Bostock, 14, 8, 22, 0, 81
Mon Mar 19 21:45:28 GMT 2012, Mike Bostock, Mike Bostock, 189, 186, 375, 0, 407
Sun Mar 18 18:03:29 GMT 2012, Mike Bostock, Mike Bostock, 8, 2, 10, 0, 20
Sun Mar 18 18:02:43 GMT 2012, Mike Bostock, Mike Bostock, 4, 0, 4, 0, 47
Sat Mar 17 23:18:59 GMT 2012, Mike Bostock, Mike Bostock, 240, 0, 240, 0, 22
Sat Mar 17 00:40:58 GMT 2012, Mike Bostock, Mike Bostock, 76, 52, 128, 0, 17
Sat Mar 17 00:32:33 GMT 2012, Mike Bostock, Mike Bostock, 38, 6, 44, 0, 17
Sat Mar 17 00:16:58 GMT 2012, Mike Bostock, Mike Bostock, 41, 34, 75, 0, 34
Fri Mar 16 17:46:21 GMT 2012, Jason Davies, Jason Davies, 6, 8, 14, 0, 57
Fri Mar 16 16:52:44 GMT 2012, Jason Davies, Jason Davies, 6, 6, 12, 0, 56
Fri Mar 16 16:50:07 GMT 2012, Jason Davies, Jason Davies, working on the server, 10, 6, 16, 0, 100
Fri Mar 16 16:42:02 GMT 2012, Jason Davies, Jason Davies, 4, 4, 8, 0, 151
Fri Mar 16 16:21:03 GMT 2012, Jason Davies, Jason Davies, 6, 4, 10, 0, 138
Fri Mar 16 14:49:10 GMT 2012, Jason Davies, Jason Davies, 3, 3, 6, 0, 177
Fri Mar 16 01:14:48 GMT 2012, Kristofer Monisit, Kristofer Monisit, 5, 9, 14, 0, 41
Thu Mar 15 15:28:21 GMT 2012, Mike Bostock, Mike Bostock, 4, 0, 4, 0, 80
Thu Mar 15 08:56:43 GMT 2012, Kristofer Monisit, Kristofer Monisit, 11, 5, 16, 0, 50
Fri Mar 09 00:08:41 GMT 2012, David Poncelow, David Poncelow, 1, 1, 2, 0, 54
Thu Mar 08 23:44:09 GMT 2012, David Poncelow, David Poncelow, 5, 2, 7, 0, 52
Thu Mar 08 09:41:13 GMT 2012, Mike Bostock, Mike Bostock, 12, 5, 17, 0, 104
Wed Mar 07 01:41:13 GMT 2012, Mike Bostock, Mike Bostock, 1, 1, 2, 0, 61
Tue Mar 06 23:36:00 GMT 2012, Carlos Scheidegger, Carlos Scheidegger, 1, 1, 2, 0, 16
Sun Mar 04 19:41:39 GMT 2012, Jason Davies, Jason Davies, 6, 6, 12, 0, 83
Sun Mar 04 11:52:51 GMT 2012, Jason Davies, Jason Davies, 1, 1, 2, 0, 9
Sun Mar 04 11:37:24 GMT 2012, Jason Davies, Jason Davies, 4, 2, 6, 0, 41
Sun Mar 04 11:31:47 GMT 2012, Jason Davies, Jason Davies, 10, 6, 16, 0, 180
Fri Mar 02 00:30:25 GMT 2012, Mike Bostock, Mike Bostock, 377, 322, 699, 0, 22
Fri Mar 02 00:29:35 GMT 2012, Mike Bostock, Mike Bostock, 82, 64, 146, 0, 43
Fri Mar 02 00:29:17 GMT 2012, Mike Bostock, Mike Bostock, 180, 235, 415, 0, 53
Fri Mar 02 00:25:30 GMT 2012, Mike Bostock, Mike Bostock, 4, 4, 8, 0, 100
Wed Feb 29 19:27:30 GMT 2012, Mike Bostock, Mike Bostock, 180, 235, 415, 0, 124
Wed Feb 29 02:27:40 GMT 2012, Mike Bostock, Mike Bostock, 116, 24, 140, 0, 320
Wed Feb 29 01:52:16 GMT 2012, Mike Bostock, Mike Bostock, 113, 67, 180, 0, 25
Mon Feb 27 00:16:49 GMT 2012, Mike Bostock, Mike Bostock, 20, 14, 34, 0, 178
Sun Feb 26 23:46:26 GMT 2012, Mike Bostock, Mike Bostock, 76, 64, 140, 0, 469
Sat Feb 25 07:36:51 GMT 2012, Mike Bostock, Mike Bostock, 2, 2, 4, 0, 62
Sat Feb 25 05:14:55 GMT 2012, Stephen Bannasch, Stephen Bannasch, 1, 1, 2, 0, 378
Sat Feb 25 03:19:34 GMT 2012, Mike Bostock, Mike Bostock, 4413, 2381, 6794, 0, 21
Thu Feb 23 18:32:42 GMT 2012, Mike Bostock, Mike Bostock, 174, 8, 182, 0, 174
Thu Feb 23 06:50:40 GMT 2012, Mike Bostock, Mike Bostock, 12, 12, 24, 0, 27
Thu Feb 23 06:40:44 GMT 2012, Mike Bostock, Mike Bostock, 414, 454, 868, 0, 92
Thu Feb 23 05:59:13 GMT 2012, Mike Bostock, Mike Bostock, 122, 170, 292, 0, 51
Thu Feb 23 05:39:02 GMT 2012, Mike Bostock, Mike Bostock, 41, 17, 58, 0, 349
Thu Feb 23 01:58:25 GMT 2012, Mike Bostock, Mike Bostock, 61, 36, 97, 0, 64
Thu Feb 23 01:22:00 GMT 2012, Mike Bostock, Mike Bostock, 170, 150, 320, 0, 328
Wed Feb 22 22:13:25 GMT 2012, Mike Bostock, Mike Bostock, 36, 24, 60, 0, 38
Wed Feb 22 22:06:30 GMT 2012, Mike Bostock, Mike Bostock, 59, 18, 77, 0, 37
Wed Feb 22 07:17:59 GMT 2012, Mike Bostock, Mike Bostock, 8, 8, 16, 0, 37
Wed Feb 22 06:14:36 GMT 2012, Mike Bostock, Mike Bostock, 105, 5, 110, 0, 76
Wed Feb 22 06:05:21 GMT 2012, Mike Bostock, Mike Bostock, 37, 6, 43, 0, 68
Wed Feb 22 05:55:18 GMT 2012, Mike Bostock, Mike Bostock, 153, 77, 230, 0, 75
Wed Feb 22 02:31:55 GMT 2012, Mike Bostock, Mike Bostock, 54, 14, 68, 0, 237
Wed Feb 22 00:07:01 GMT 2012, Michael Jackson, Michael Jackson, 4, 0, 4, 0, 32
Tue Feb 21 18:41:43 GMT 2012, Mike Bostock, Mike Bostock, 110, 59, 169, 1, 254
Tue Feb 21 18:31:15 GMT 2012, Mike Bostock, Mike Bostock, 105, 67, 172, 0, 32
Tue Feb 21 18:03:23 GMT 2012, Mike Bostock, Mike Bostock, 24, 32, 56, 0, 189
Tue Feb 21 17:04:00 GMT 2012, Mike Bostock, Mike Bostock, 9, 9, 18, 0, 27
Tue Feb 21 16:57:55 GMT 2012, Mike Bostock, Mike Bostock, 31, 22, 53, 0, 32
Tue Feb 21 16:55:03 GMT 2012, Mike Bostock, Mike Bostock, 30, 16, 46, 0, 45
Tue Feb 21 16:47:57 GMT 2012, Mike Bostock, Mike Bostock, 48, 40, 88, 0, 33
Tue Feb 21 16:42:37 GMT 2012, Mike Bostock, Mike Bostock, 15, 6, 21, 0, 44
Tue Feb 21 16:39:42 GMT 2012, Mike Bostock, Mike Bostock, 40, 24, 64, 0, 105
Tue Feb 21 16:23:23 GMT 2012, Mike Bostock, Mike Bostock, 18, 18, 36, 0, 265
Tue Feb 21 16:18:27 GMT 2012, Mike Bostock, Mike Bostock, 4, 6, 10, 0, 86
Tue Feb 21 13:15:38 GMT 2012, Jason Davies, Jason Davies, 4, 6, 10, 0, 122
Tue Feb 21 06:57:25 GMT 2012, Mike Bostock, Mike Bostock, 18, 18, 36, 0, 40
Tue Feb 21 06:54:38 GMT 2012, Mike Bostock, Mike Bostock, 15, 17, 32, 0, 29
Tue Feb 21 06:49:31 GMT 2012, Mike Bostock, Mike Bostock, 22, 15, 37, 0, 182
Tue Feb 21 06:32:46 GMT 2012, Mike Bostock, Mike Bostock, 14, 8, 22, 0, 32
Tue Feb 21 06:28:42 GMT 2012, Mike Bostock, Mike Bostock, 7, 7, 14, 0, 97
Tue Feb 21 05:26:27 GMT 2012, Mike Bostock, Mike Bostock, 127, 61, 188, 0, 270
Tue Feb 21 04:40:43 GMT 2012, Mike Bostock, Mike Bostock, 61, 50, 111, 0, 166
Tue Feb 21 04:24:11 GMT 2012, Mike Bostock, Mike Bostock, 18, 18, 36, 0, 28
Tue Feb 21 04:14:24 GMT 2012, Mike Bostock, Mike Bostock, 12, 48, 60, 0, 23
Mon Feb 20 20:28:10 GMT 2012, Zee Agency, Zee Agency, 3, 0, 3, 0, 59
Mon Feb 20 20:25:23 GMT 2012, Jason Davies, Jason Davies, 7, 5, 12, 0, 9
Mon Feb 20 19:57:19 GMT 2012, Jason Davies, Jason Davies, 373, 53, 426, 0, 49
Mon Feb 20 19:23:36 GMT 2012, Mike Bostock, Mike Bostock, 265, 4, 269, 0, 235
Mon Feb 20 08:52:45 GMT 2012, Jason Davies, Jason Davies, 24, 11, 35, 0, 49
Mon Feb 20 05:00:01 GMT 2012, Jason Davies, Jason Davies, 3, 7, 10, 0, 26
Mon Feb 20 04:52:53 GMT 2012, Jason Davies, Jason Davies, 1, 2, 3, 0, 9
Mon Feb 20 04:52:44 GMT 2012, Mike Bostock, Mike Bostock, 66, 5, 71, 0, 34
Mon Feb 20 04:46:52 GMT 2012, Jason Davies, Jason Davies, 2374, 1353, 3727, 0, 96
Mon Feb 20 04:45:58 GMT 2012, Jason Davies, Jason Davies, 5, 7, 12, 0, 9
Mon Feb 20 04:43:44 GMT 2012, Jason Davies, Jason Davies, 13, 13, 26, 0, 39
Mon Feb 20 04:15:14 GMT 2012, Jason Davies, Jason Davies, 6, 6, 12, 0, 95
Mon Feb 20 04:11:48 GMT 2012, Jason Davies, Jason Davies, 6, 6, 12, 0, 150
Mon Feb 20 04:06:20 GMT 2012, Jason Davies, Jason Davies, 45, 13, 58, 0, 46
Mon Feb 20 03:31:02 GMT 2012, Jason Davies, Jason Davies, 15, 9, 24, 0, 53
Mon Feb 20 03:18:43 GMT 2012, Mike Bostock, Mike Bostock, 47, 13, 60, 0, 29
Mon Feb 20 03:18:10 GMT 2012, Jason Davies, Jason Davies, 22, 11, 33, 0, 219
Mon Feb 20 01:14:41 GMT 2012, Mike Bostock, Mike Bostock, 248, 115, 363, 0, 80
Mon Feb 20 01:00:04 GMT 2012, Mike Bostock, Mike Bostock, 70, 72, 142, 0, 777
Sun Feb 19 23:56:06 GMT 2012, Jason Davies, Jason Davies, 6, 6, 12, 0, 71
Sun Feb 19 23:54:42 GMT 2012, Jason Davies, Jason Davies, 93, 0, 93, 0, 235
Sun Feb 19 23:20:56 GMT 2012, Jason Davies, Jason Davies, 8, 8, 16, 0, 9
Sun Feb 19 23:20:30 GMT 2012, Jason Davies, Jason Davies, 1, 1, 2, 0, 17
Sun Feb 19 21:35:09 GMT 2012, Mike Bostock, Mike Bostock, 1, 1, 2, 0, 22
Sun Feb 19 21:34:19 GMT 2012, Mike Bostock, Mike Bostock, 0, 6, 6, 0, 21
Sun Feb 19 21:28:16 GMT 2012, Mike Bostock, Mike Bostock, 505, 539, 1044, 0, 38
Sun Feb 19 21:24:17 GMT 2012, Mike Bostock, Mike Bostock, 299, 119, 418, 0, 52
Sun Feb 19 20:24:38 GMT 2012, Mike Bostock, Mike Bostock, 399, 5, 404, 0, 163
Sun Feb 19 20:13:34 GMT 2012, Jason Davies, Jason Davies, 8033, 13854, 21887, 0, 100
Sun Feb 19 20:10:47 GMT 2012, Jason Davies, Jason Davies, 95, 95, 190, 0, 29
Sun Feb 19 19:54:32 GMT 2012, Jason Davies, Jason Davies, 6, 4, 10, 0, 307
Sun Feb 19 06:56:54 GMT 2012, Mike Bostock, Mike Bostock, 383, 337, 720, 0, 718
Sun Feb 19 06:00:47 GMT 2012, Mike Bostock, Mike Bostock, 99, 167, 266, 0, 112
Sun Feb 19 05:23:17 GMT 2012, Mike Bostock, Mike Bostock, 556, 206, 762, 0, 30
Sun Feb 19 04:36:06 GMT 2012, Mike Bostock, Mike Bostock, 144, 150, 294, 0, 197
Sat Feb 18 21:14:52 GMT 2012, Mike Bostock, Mike Bostock, 5612, 6901, 12513, 1, 648
Sat Feb 18 21:10:03 GMT 2012, Mike Bostock, Mike Bostock, 109, 65, 174, 0, 21
Sat Feb 18 21:05:02 GMT 2012, Mike Bostock, Mike Bostock, 34, 18, 52, 0, 368
Sat Feb 18 19:48:11 GMT 2012, Mike Bostock, Mike Bostock, 3, 1, 4, 0, 47
Sat Feb 18 19:46:18 GMT 2012, Mike Bostock, Mike Bostock, 27, 1, 28, 0, 46
Sat Feb 18 19:40:32 GMT 2012, Mike Bostock, Mike Bostock, 23, 31, 54, 0, 70
Sat Feb 18 19:39:43 GMT 2012, Mike Bostock, Mike Bostock, 14, 6, 20, 0, 41
Sat Feb 18 19:39:24 GMT 2012, Mike Bostock, Mike Bostock, 7, 7, 14, 0, 74
Fri Feb 17 16:40:27 GMT 2012, Mike Bostock, Mike Bostock, 34, 26, 60, 0, 32
Fri Feb 17 15:56:55 GMT 2012, Jason Davies, Jason Davies, 266, 8, 274, 0, 105
Fri Feb 17 14:23:38 GMT 2012, Jason Davies, Jason Davies, 30, 10, 40, 0, 52
Thu Feb 16 16:43:19 GMT 2012, Mike Bostock, Mike Bostock, 236, 0, 236, 0, 88
Thu Feb 16 16:19:53 GMT 2012, Jason Davies, Jason Davies, 2, 2, 4, 0, 41
Thu Feb 16 16:16:51 GMT 2012, Jason Davies, Jason Davies, 18, 0, 18, 0, 51
Thu Feb 16 12:49:20 GMT 2012, Jason Davies, Jason Davies, 7, 7, 14, 0, 324
Thu Feb 16 09:50:16 GMT 2012, Jason Davies, Jason Davies, 3, 5, 8, 0, 15
Thu Feb 16 09:45:50 GMT 2012, Jason Davies, Jason Davies, 13, 20, 33, 0, 9
Thu Feb 16 09:02:06 GMT 2012, Jason Davies, Jason Davies, 227, 0, 227, 0, 375
Wed Feb 15 22:23:27 GMT 2012, Trevor Norris, Trevor Norris, 33, 17, 50, 0, 126
Wed Feb 15 06:26:12 GMT 2012, Mike Bostock, Mike Bostock, 5, 5, 10, 0, 252
Wed Feb 15 06:07:57 GMT 2012, Mike Bostock, Mike Bostock, 30, 23, 53, 0, 272
Wed Feb 15 05:59:47 GMT 2012, Ian Malpass, Ian Malpass, 13, 1, 14, 0, 51
Wed Feb 15 05:18:42 GMT 2012, Ian Malpass, Ian Malpass, 17, 5, 22, 0, 146
Wed Feb 15 00:32:47 GMT 2012, Mike Bostock, Mike Bostock, 250, 107, 357, 0, 706
Wed Feb 15 00:43:15 GMT 2012, Mike Bostock, Mike Bostock, 5, 6, 11, 0, 43
Wed Feb 15 00:09:52 GMT 2012, Trevor Norris, Trevor Norris, 1, 1, 2, 0, 30
Wed Feb 15 00:04:03 GMT 2012, Trevor Norris, Trevor Norris, 6, 3, 9, 0, 26
Wed Feb 15 00:03:38 GMT 2012, Trevor Norris, Trevor Norris, 6, 2, 8, 0, 88
Tue Feb 14 20:14:45 GMT 2012, Jason Davies, Jason Davies, 73, 0, 73, 0, 39
Tue Feb 14 18:49:16 GMT 2012, Jason Davies, Jason Davies, 2, 0, 2, 0, 18
Tue Feb 14 18:46:48 GMT 2012, Jason Davies, Jason Davies, 6, 30, 36, 0, 61
Tue Feb 14 18:45:13 GMT 2012, Jason Davies, Jason Davies, 1571, 1567, 3138, 0, 65
Tue Feb 14 07:11:05 GMT 2012, Mike Bostock, Mike Bostock, 14, 6, 20, 0, 46
Mon Feb 13 21:44:35 GMT 2012, Jason Davies, Jason Davies, 12, 12, 24, 0, 40
Sun Feb 12 16:41:58 GMT 2012, Mike Bostock, Mike Bostock, 2, 2, 4, 0, 47
Fri Feb 10 09:16:56 GMT 2012, Jason Davies, Jason Davies, 3, 13, 16, 0, 23
Thu Feb 09 17:09:23 GMT 2012, Mike Bostock, Mike Bostock, 27, 1, 28, 0, 165
Thu Feb 09 00:23:40 GMT 2012, Jason Davies, Jason Davies, 2, 2, 4, 0, 50
Thu Feb 09 00:20:59 GMT 2012, Jason Davies, Jason Davies, 4, 2, 6, 0, 49
Wed Feb 08 21:46:01 GMT 2012, Jason Davies, Jason Davies, 2, 2, 4, 0, 28
Tue Feb 07 22:37:18 GMT 2012, Trevor Norris, Trevor Norris, 11, 4, 15, 0, 26
Tue Feb 07 22:09:39 GMT 2012, Trevor Norris, Trevor Norris, 10, 2, 12, 0, 44
Fri Feb 03 01:41:35 GMT 2012, Mike Bostock, Mike Bostock, 434, 538, 972, 5, 1546
Thu Feb 02 04:07:45 GMT 2012, Mike Bostock, Mike Bostock, 336, 76, 412, 0, 22
Thu Feb 02 04:06:44 GMT 2012, Mike Bostock, Mike Bostock, 282, 48, 330, 0, 119
Mon Jan 30 03:23:14 GMT 2012, Mike Bostock, Mike Bostock, 98, 4, 102, 0, 46
Sun Jan 29 22:27:41 GMT 2012, Mike Bostock, Mike Bostock, 51, 25, 76, 0, 146
Sun Jan 29 21:44:48 GMT 2012, Mike Bostock, Mike Bostock, 11, 7, 18, 0, 56
Sun Jan 29 21:28:49 GMT 2012, Mike Bostock, Mike Bostock, 151, 26, 177, 0, 355
Sun Jan 29 18:43:22 GMT 2012, Mike Bostock, Mike Bostock, 24, 13, 37, 0, 86
Thu Jan 26 19:58:40 GMT 2012, Mike Bostock, Mike Bostock, 4, 1, 5, 0, 32
Thu Jan 26 19:18:42 GMT 2012, Mike Bostock, Mike Bostock, 307, 5433, 5740, 0, 20
Thu Jan 26 19:05:06 GMT 2012, Mike Bostock, Mike Bostock, 6, 5, 11, 2, 70
Thu Jan 26 19:02:17 GMT 2012, Mike Bostock, Mike Bostock, 2, 3, 5, 0, 65
Thu Jan 26 19:01:52 GMT 2012, Mike Bostock, Mike Bostock, 5, 5, 10, 0, 65
Thu Jan 26 18:48:32 GMT 2012, Mike Bostock, Mike Bostock, 17, 35, 52, 0, 78
Thu Jan 26 16:29:26 GMT 2012, Nathan Vander Wilt, Nathan Vander Wilt, 6, 6, 12, 0, 53
Thu Jan 26 00:20:08 GMT 2012, Jason Davies, Jason Davies, 8, 4, 12, 0, 33
Thu Jan 26 08:16:44 GMT 2012, Mike Bostock, Mike Bostock, 3, 3, 6, 0, 167
Wed Jan 25 17:23:38 GMT 2012, Jason Davies, Jason Davies, 17, 35, 52, 0, 39
Tue Jan 24 17:04:46 GMT 2012, Nathan Vander Wilt, Nathan Vander Wilt, 142, 46, 188, 0, 97
Tue Jan 24 05:43:11 GMT 2012, Nathan Vander Wilt, Nathan Vander Wilt, 26, 10, 36, 0, 51
Tue Jan 24 02:15:52 GMT 2012, Mike Bostock, Mike Bostock, 236, 5374, 5610, 0, 39
Mon Jan 23 23:23:10 GMT 2012, Mike Bostock, Mike Bostock, 3, 3, 6, 0, 31
Mon Jan 23 23:02:18 GMT 2012, Mike Bostock, Mike Bostock, 7, 7, 14, 0, 30
Mon Jan 23 21:35:08 GMT 2012, Andrew Sutherland, Andrew Sutherland, 5, 5, 10, 0, 26
Mon Jan 23 20:45:10 GMT 2012, Andrew Sutherland, Andrew Sutherland, 4, 4, 8, 0, 21
Mon Jan 23 02:43:23 GMT 2012, Jim Radford, Jim Radford, 2, 3, 5, 0, 24
Sun Jan 22 18:12:41 GMT 2012, Mike Bostock, Mike Bostock, 7, 3, 10, 0, 30
Thu Jan 19 20:48:21 GMT 2012, Lars Kotthoff, Lars Kotthoff, 1, 1, 2, 0, 34
Sun Oct 30 11:12:25 GMT 2011, Lars Kotthoff, Lars Kotthoff, 46, 4, 50, 0, 66
Sat Oct 29 23:34:11 BST 2011, Lars Kotthoff, Lars Kotthoff, 11, 4, 15, 0, 58
Tue Oct 11 19:48:43 BST 2011, Lars Kotthoff, Lars Kotthoff, 1, 1, 2, 0, 22
Tue Oct 11 19:43:22 BST 2011, Lars Kotthoff, Lars Kotthoff, 1, 1, 2, 0, 79
Tue Oct 04 20:01:52 BST 2011, Lars Kotthoff, Lars Kotthoff, 5, 0, 5, 0, 37
Sat Oct 01 15:27:25 BST 2011, Lars Kotthoff, Lars Kotthoff, 1, 1, 2, 0, 153
Wed Jan 18 21:10:00 GMT 2012, Mike Bostock, Mike Bostock, 34, 8, 42, 0, 57
Tue Jan 17 21:08:48 GMT 2012, Mike Bostock, Mike Bostock, 1, 4, 5, 0, 47
Tue Jan 17 21:07:17 GMT 2012, Mike Bostock, Mike Bostock, 86, 42, 128, 0, 22
Tue Jan 17 21:02:19 GMT 2012, Mike Bostock, Mike Bostock, 39, 29, 68, 1, 552
Tue Jan 17 18:39:56 GMT 2012, Mike Bostock, Mike Bostock, 3, 3, 6, 0, 70
Fri Jan 13 17:13:40 GMT 2012, Mike Bostock, Mike Bostock, 1, 4, 5, 0, 82
Fri Jan 13 13:16:14 GMT 2012, Jason Davies, Jason Davies, 1, 4, 5, 0, 33
Mon Jan 09 08:41:36 GMT 2012, Jason Davies, Jason Davies, 15, 15, 30, 0, 52
Mon Jan 09 08:39:57 GMT 2012, Jason Davies, Jason Davies, 26, 26, 52, 0, 47
Mon Jan 09 08:35:57 GMT 2012, Jason Davies, Jason Davies, 12, 12, 24, 0, 45
Mon Jan 09 01:32:12 GMT 2012, Jason Davies, Jason Davies, 119, 61, 180, 0, 50
Mon Jan 02 00:58:38 GMT 2012, Mike Bostock, Mike Bostock, 25, 1, 26, 0, 98
Sun Jan 01 20:15:22 GMT 2012, Mike Bostock, Mike Bostock, 18, 8, 26, 0, 39
Sun Jan 01 19:44:49 GMT 2012, Mike Bostock, Mike Bostock, 10, 0, 10, 0, 28
Sat Dec 31 09:28:42 GMT 2011, Jason Davies, Jason Davies, 3, 3, 6, 0, 198
Fri Dec 30 20:00:45 GMT 2011, Mike Bostock, Mike Bostock, 155, 79, 234, 0, 20
Fri Dec 30 19:58:51 GMT 2011, Mike Bostock, Mike Bostock, 15, 7, 22, 0, 70
Fri Dec 30 19:58:36 GMT 2011, Mike Bostock, Mike Bostock, 13, 3, 16, 0, 70
Fri Dec 30 19:57:46 GMT 2011, Mike Bostock, Mike Bostock, 37, 15, 52, 0, 66
Fri Dec 30 19:57:32 GMT 2011, Mike Bostock, Mike Bostock, 12, 4, 16, 0, 75
Fri Dec 30 19:56:59 GMT 2011, Mike Bostock, Mike Bostock, 47, 24, 71, 0, 82
Fri Dec 30 19:24:59 GMT 2011, Mike Bostock, Mike Bostock, 18, 14, 32, 0, 65
Fri Dec 30 19:16:49 GMT 2011, Mike Bostock, Mike Bostock, 8, 7, 15, 0, 45
Fri Dec 30 19:05:52 GMT 2011, Mike Bostock, Mike Bostock, 9, 9, 18, 0, 31
Fri Dec 30 18:41:40 GMT 2011, Jason Davies, Jason Davies, 8, 4, 12, 0, 134
Wed Dec 28 11:41:55 GMT 2011, Jason Davies, Jason Davies, 4, 4, 8, 0, 27
Tue Dec 27 18:08:22 GMT 2011, Mike Bostock, Mike Bostock, 18, 14, 32, 0, 31
Tue Dec 27 17:59:12 GMT 2011, Mike Bostock, Mike Bostock, 0, 0, 0, 0, 72
Tue Dec 27 10:24:46 GMT 2011, Ger Hobbelt, Ger Hobbelt, 4, 4, 8, 0, 267
Tue Dec 27 08:32:15 GMT 2011, Andy Chong, Andy Chong, 1, 1, 2, 0, 148
Tue Dec 20 22:22:01 GMT 2011, Gerard Hundman, Gerard Hundman, 8, 4, 12, 0, 122
Tue Dec 20 16:39:01 GMT 2011, Mike Bostock, Mike Bostock, 1, 1, 2, 0, 100
Thu Dec 15 19:07:12 GMT 2011, Jason Davies, Jason Davies, 13, 13, 26, 0, 63
Thu Dec 15 17:55:03 GMT 2011, Jason Davies, Jason Davies, 46, 13, 59, 0, 62
Wed Dec 14 09:27:58 GMT 2011, Jason Davies, Jason Davies, 2, 0, 2, 0, 45
Wed Dec 14 09:21:15 GMT 2011, Jason Davies, Jason Davies, 12, 12, 24, 0, 37
Wed Dec 14 09:15:25 GMT 2011, Jason Davies, Jason Davies, 15, 9, 24, 0, 48
Tue Dec 13 14:43:15 GMT 2011, Jason Davies, Jason Davies, 2, 2, 4, 0, 23
Tue Dec 13 13:40:46 GMT 2011, Jason Davies, Jason Davies, 1, 1, 2, 0, 23
Tue Dec 13 13:39:36 GMT 2011, Jason Davies, Jason Davies, 11, 19, 30, 0, 34
Tue Dec 13 13:32:51 GMT 2011, Jason Davies, Jason Davies, 35, 5, 40, 0, 63
Tue Dec 13 12:43:37 GMT 2011, Jason Davies, Jason Davies, 13, 3, 16, 0, 154
Sun Dec 11 02:24:09 GMT 2011, Mike Bostock, Mike Bostock, 9, 9, 18, 0, 22
Sat Dec 10 09:42:12 GMT 2011, Jason Davies, Jason Davies, 13, 9, 22, 0, 366
Fri Dec 09 02:06:31 GMT 2011, Mike Bostock, Mike Bostock, 137, 30, 167, 0, 20
Fri Dec 09 01:55:46 GMT 2011, Mike Bostock, Mike Bostock, 1, 0, 1, 0, 18
Fri Dec 09 01:54:31 GMT 2011, Mike Bostock, Mike Bostock, 15, 2, 17, 0, 79
Fri Dec 09 01:49:22 GMT 2011, Mike Bostock, Mike Bostock, 37, 8, 45, 0, 50
Fri Dec 09 01:14:08 GMT 2011, Mike Bostock, Mike Bostock, 83, 19, 102, 0, 149
Wed Dec 07 00:07:45 GMT 2011, Nathan Vander Wilt, Nathan Vander Wilt, 15, 2, 17, 0, 47
Wed Nov 30 05:57:58 GMT 2011, Mike Bostock, Mike Bostock, 535, 529, 1064, 0, 22
Wed Nov 30 05:57:20 GMT 2011, Mike Bostock, Mike Bostock, 10, 8, 18, 0, 50
Wed Nov 30 05:56:46 GMT 2011, Mike Bostock, Mike Bostock, 7, 3, 10, 0, 45
Wed Nov 30 05:55:51 GMT 2011, Mike Bostock, Mike Bostock, 10, 8, 18, 0, 40
Wed Nov 30 05:36:51 GMT 2011, Mike Bostock, Mike Bostock, 7, 3, 10, 0, 9
Wed Nov 23 22:54:09 GMT 2011, Jason Davies, Jason Davies, 20, 20, 40, 0, 47
Wed Nov 23 22:46:37 GMT 2011, Jason Davies, Jason Davies, 498, 498, 996, 0, 47
Wed Nov 23 21:04:39 GMT 2011, Mike Bostock, Mike Bostock, 7, 7, 14, 0, 28
Wed Nov 23 21:00:39 GMT 2011, Mike Bostock, Mike Bostock, 603, 225, 828, 0, 22
Wed Nov 23 20:59:49 GMT 2011, Mike Bostock, Mike Bostock, 41, 2, 43, 0, 37
Wed Nov 23 20:59:31 GMT 2011, Mike Bostock, Mike Bostock, 341, 117, 458, 0, 40
Wed Nov 23 20:59:06 GMT 2011, Mike Bostock, Mike Bostock, 181, 75, 256, 0, 32
Wed Nov 23 20:52:56 GMT 2011, Mike Bostock, Mike Bostock, 31, 30, 61, 0, 267
Wed Nov 23 20:44:49 GMT 2011, Mike Bostock, Mike Bostock, 8686, 1910, 10596, 0, 44
Wed Nov 23 20:44:04 GMT 2011, Mike Bostock, Mike Bostock, 41, 2, 43, 0, 14
Wed Nov 23 20:30:49 GMT 2011, Mike Bostock, Mike Bostock, 134, 26, 160, 0, 228
Wed Nov 23 20:05:52 GMT 2011, Mike Bostock, Mike Bostock, 211, 95, 306, 0, 24
Tue Nov 22 22:38:43 GMT 2011, Mike Bostock, Mike Bostock, 127, 133, 260, 0, 27
Tue Nov 22 22:36:09 GMT 2011, Mike Bostock, Mike Bostock, 107, 121, 228, 0, 188
Tue Nov 22 21:08:55 GMT 2011, Mike Bostock, Mike Bostock, 22, 14, 36, 0, 602
Sat Nov 19 00:52:35 GMT 2011, Mike Bostock, Mike Bostock, 4, 0, 4, 0, 15
Wed Nov 16 21:55:11 GMT 2011, Mike Bostock, Mike Bostock, 136, 26, 162, 0, 22
Wed Nov 16 21:54:20 GMT 2011, Mike Bostock, Mike Bostock, 121, 16, 137, 0, 37
Wed Nov 16 21:53:28 GMT 2011, Mike Bostock, Mike Bostock, 25, 16, 41, 0, 30
Wed Nov 16 21:45:28 GMT 2011, Mike Bostock, Mike Bostock, 6, 10, 16, 0, 22
Wed Nov 16 21:23:33 GMT 2011, Jason Davies, Jason Davies, 1, 1, 2, 0, 13
Wed Nov 16 21:16:14 GMT 2011, Jason Davies, Jason Davies, 115, 12, 127, 0, 214
Wed Nov 16 01:17:05 GMT 2011, Mike Bostock, Mike Bostock, 4, 2, 6, 0, 36
Wed Nov 16 01:16:26 GMT 2011, Mike Bostock, Mike Bostock, 25, 16, 41, 0, 31
Tue Nov 15 00:07:11 GMT 2011, Mike Bostock, Mike Bostock, 16, 10, 26, 0, 195
Mon Nov 14 15:59:11 GMT 2011, Mike Bostock, Mike Bostock, 11, 11, 22, 0, 47
Mon Nov 14 02:28:09 GMT 2011, Mike Bostock, Mike Bostock, 14, 5, 19, 0, 42
Thu Nov 10 23:46:07 GMT 2011, Mike Bostock, Mike Bostock, 60, 48, 108, 0, 308
Thu Nov 10 23:16:46 GMT 2011, Mike Bostock, Mike Bostock, 139, 47, 186, 0, 335
Thu Nov 10 20:35:09 GMT 2011, Mike Bostock, Mike Bostock, 8, 3, 11, 0, 79
Thu Nov 10 20:31:54 GMT 2011, Mike Bostock, Mike Bostock, 7, 7, 14, 0, 25
Wed Nov 09 19:29:27 GMT 2011, Mike Bostock, Mike Bostock, 11, 11, 22, 0, 109
Sat Nov 05 01:53:22 GMT 2011, Jason Davies, Jason Davies, 11, 11, 22, 0, 230
Sat Nov 05 02:42:59 GMT 2011, Mike Bostock, Mike Bostock, 6, 6, 12, 0, 40
Sat Nov 05 02:36:50 GMT 2011, Mike Bostock, Mike Bostock, 2310, 411, 2721, 0, 20
Sat Nov 05 02:06:43 GMT 2011, Mike Bostock, Mike Bostock, 197, 18, 215, 0, 35
Sat Nov 05 02:05:06 GMT 2011, Mike Bostock, Mike Bostock, 60, 0, 60, 0, 33
Sat Nov 05 02:03:17 GMT 2011, Mike Bostock, Mike Bostock, 8, 10, 18, 0, 31
Sat Nov 05 01:08:53 GMT 2011, Mike Bostock, Mike Bostock, 4, 4, 8, 0, 74
Fri Nov 04 23:46:35 GMT 2011, Mike Bostock, Mike Bostock, 28, 14, 42, 0, 44
Fri Nov 04 23:19:58 GMT 2011, Mike Bostock, Mike Bostock, 113, 6, 119, 0, 196
Fri Nov 04 22:14:06 GMT 2011, Mike Bostock, Mike Bostock, 52, 52, 104, 0, 16
Fri Nov 04 22:13:44 GMT 2011, Mike Bostock, Mike Bostock, 7, 3, 10, 0, 74
Fri Nov 04 22:12:05 GMT 2011, Jason Davies, Jason Davies, 4, 4, 8, 0, 141
Fri Nov 04 22:01:55 GMT 2011, Jason Davies, Jason Davies, 7, 3, 10, 0, 49
Fri Nov 04 21:10:01 GMT 2011, Mike Bostock, Mike Bostock, 6, 20, 26, 0, 36
Fri Nov 04 20:48:56 GMT 2011, Mike Bostock, Mike Bostock, 1, 1, 2, 0, 44
Fri Nov 04 20:41:02 GMT 2011, Mike Bostock, Mike Bostock, 18, 10, 28, 0, 74
Fri Nov 04 20:39:06 GMT 2011, Mike Bostock, Mike Bostock, 5, 11, 16, 0, 20
Fri Nov 04 20:38:13 GMT 2011, Jason Davies, Jason Davies, 18, 10, 28, 0, 22
Fri Nov 04 20:35:09 GMT 2011, Jason Davies, Jason Davies, 3, 3, 6, 0, 35
Fri Nov 04 20:32:14 GMT 2011, Mike Bostock, Mike Bostock, 3, 3, 6, 0, 14
Fri Nov 04 20:25:45 GMT 2011, Jason Davies, Jason Davies, 2078, 404, 2482, 0, 113
Fri Nov 04 20:22:27 GMT 2011, Jason Davies, Jason Davies, 3, 3, 6, 0, 46
Fri Nov 04 20:19:14 GMT 2011, Jason Davies, Jason Davies, 8, 8, 16, 0, 23
Fri Nov 04 20:18:19 GMT 2011, Mike Bostock, Mike Bostock, 14, 10, 24, 0, 73
Fri Nov 04 20:18:18 GMT 2011, Jason Davies, Jason Davies, 4, 26, 30, 0, 137
Fri Nov 04 20:14:20 GMT 2011, Jason Davies, Jason Davies, 14, 12, 26, 0, 119
Fri Nov 04 19:41:42 GMT 2011, Mike Bostock, Mike Bostock, 104, 34, 138, 0, 73
Fri Nov 04 19:03:01 GMT 2011, Mike Bostock, Mike Bostock, 21, 12, 33, 0, 251
Fri Nov 04 18:28:27 GMT 2011, Mike Bostock, Mike Bostock, 19, 12, 31, 0, 42
Fri Nov 04 00:04:02 GMT 2011, Mike Bostock, Mike Bostock, 41, 6, 47, 0, 79
Fri Nov 04 00:02:19 GMT 2011, Mike Bostock, Mike Bostock, 70, 61, 131, 0, 47
Thu Nov 03 17:34:02 GMT 2011, Jason Davies, Jason Davies, 15, 23, 38, 0, 133
Thu Nov 03 16:59:41 GMT 2011, Jason Davies, Jason Davies, 102, 6, 108, 0, 32
Thu Nov 03 16:20:06 GMT 2011, Mike Bostock, Mike Bostock, 57, 5, 62, 0, 113
Thu Nov 03 16:06:04 GMT 2011, Mike Bostock, Mike Bostock, 1, 0, 1, 0, 28
Wed Nov 02 23:19:37 GMT 2011, Mike Bostock, Mike Bostock, 562, 6, 568, 0, 191
Wed Nov 02 18:44:29 GMT 2011, Mike Bostock, Mike Bostock, 152, 152, 304, 0, 512
Wed Nov 02 16:18:57 GMT 2011, Mike Bostock, Mike Bostock, 1, 1, 2, 0, 85
Wed Nov 02 12:32:50 GMT 2011, Jason Davies, Jason Davies, 1, 1, 2, 0, 31
Wed Nov 02 02:14:12 GMT 2011, Mike Bostock, Mike Bostock, 106, 64, 170, 0, 44
Wed Nov 02 01:08:54 GMT 2011, Mike Bostock, Mike Bostock, 88, 25, 113, 0, 84
Tue Nov 01 23:53:09 GMT 2011, Mike Bostock, Mike Bostock, 301, 168, 469, 0, 320
Tue Nov 01 20:30:58 GMT 2011, Mike Bostock, Mike Bostock, 189, 82, 271, 0, 230
Tue Nov 01 18:57:37 GMT 2011, Mike Bostock, Mike Bostock, 112, 92, 204, 0, 17
Tue Nov 01 01:03:48 GMT 2011, Mike Bostock, Mike Bostock, 118, 22, 140, 0, 95
Mon Oct 31 23:59:17 GMT 2011, Mike Bostock, Mike Bostock, 529, 19, 548, 0, 253
Sat Oct 29 18:50:09 BST 2011, Mike Bostock, Mike Bostock, 16, 14, 30, 0, 70
Sat Oct 29 18:42:19 BST 2011, Mike Bostock, Mike Bostock, 153, 136, 289, 0, 172
Sat Oct 29 17:39:52 BST 2011, Mike Bostock, Mike Bostock, 22, 2, 24, 0, 53
Sat Oct 29 01:11:20 BST 2011, Mike Bostock, Mike Bostock, 2, 0, 2, 0, 47
Sat Oct 29 01:05:50 BST 2011, Mike Bostock, Mike Bostock, 31, 32, 63, 0, 29
Sat Oct 29 01:04:03 BST 2011, Mike Bostock, Mike Bostock, 31, 32, 63, 0, 49
Sat Oct 29 00:53:58 BST 2011, Mike Bostock, Mike Bostock, 3, 3, 6, 0, 42
Sat Oct 29 00:48:03 BST 2011, Mike Bostock, Mike Bostock, 2, 3, 5, 0, 36
Sat Oct 29 00:47:31 BST 2011, Mike Bostock, Mike Bostock, 2, 2, 4, 0, 20
Tue Oct 18 21:30:20 BST 2011, Johan Sundström, Mike Bostock, 2, 3, 5, 0, 45
Sat Oct 29 00:29:23 BST 2011, Mike Bostock, Mike Bostock, 13, 8, 21, 0, 26
Sat Oct 29 00:15:07 BST 2011, Mike Bostock, Mike Bostock, 2, 1, 3, 0, 75
Tue Oct 25 09:54:19 BST 2011, Jason Davies, Jason Davies, 8, 10, 18, 0, 85
Tue Oct 25 09:52:00 BST 2011, Jason Davies, Jason Davies, 8, 12, 20, 0, 194
Tue Oct 25 09:30:59 BST 2011, Jason Davies, Jason Davies, 14, 6, 20, 0, 190
Tue Oct 25 09:12:42 BST 2011, Jason Davies, Jason Davies, 3, 3, 6, 0, 176
Mon Oct 24 03:39:40 BST 2011, Mike Bostock, Mike Bostock, 13, 9, 22, 0, 253
Thu Oct 20 15:54:24 BST 2011, Jason Davies, Jason Davies, 4, 4, 8, 0, 14
Thu Oct 20 15:52:06 BST 2011, Jason Davies, Jason Davies, 10, 10, 20, 0, 38
Thu Oct 20 15:27:02 BST 2011, Jason Davies, Jason Davies, 16, 12, 28, 0, 38
Thu Oct 20 13:15:57 BST 2011, Jason Davies, Jason Davies, 86, 62, 148, 0, 369
Thu Sep 22 15:17:23 BST 2011, Jason Davies, Jason Davies, 65, 15, 80, 0, 430
Thu Oct 20 02:01:39 BST 2011, Mike Bostock, Mike Bostock, 15, 15, 30, 0, 56
Thu Oct 20 01:57:53 BST 2011, Mike Bostock, Mike Bostock, 46, 41, 87, 0, 198
Wed Oct 19 22:23:14 BST 2011, Mike Bostock, Mike Bostock, 3, 3, 6, 0, 22
Mon Oct 17 18:27:57 BST 2011, Mike Bostock, Mike Bostock, 52, 52, 104, 0, 16
Mon Oct 17 17:54:11 BST 2011, Mike Bostock, Mike Bostock, 61, 28, 89, 0, 39
Mon Oct 17 08:43:27 BST 2011, Jason Davies, Jason Davies, 2, 2, 4, 0, 22
Fri Oct 14 21:45:16 BST 2011, Mike Bostock, Mike Bostock, 63, 24, 87, 0, 409
Mon Oct 10 08:27:24 BST 2011, Jason Davies, Jason Davies, 15, 15, 30, 0, 123
Thu Oct 13 08:30:45 BST 2011, Mike Bostock, Mike Bostock, 223, 0, 223, 0, 35
Thu Oct 13 01:55:08 BST 2011, Mike Bostock, Mike Bostock, 91, 134, 225, 0, 30
Wed Oct 12 23:37:32 BST 2011, Mike Bostock, Mike Bostock, 61, 19, 80, 0, 177
Wed Oct 12 22:02:57 BST 2011, Mike Bostock, Mike Bostock, 121, 1, 122, 0, 41
Wed Oct 12 02:02:06 BST 2011, Mike Bostock, Mike Bostock, 93, 22, 115, 0, 22
Wed Oct 12 02:01:43 BST 2011, Mike Bostock, Mike Bostock, 26, 8, 34, 0, 32
Wed Oct 12 02:01:25 BST 2011, Mike Bostock, Mike Bostock, 26, 8, 34, 0, 66
Wed Oct 12 01:46:13 BST 2011, Mike Bostock, Mike Bostock, 64, 11, 75, 0, 338
Wed Oct 12 00:46:47 BST 2011, Mike Bostock, Mike Bostock, 164, 29, 193, 0, 191
Tue Oct 11 09:06:38 BST 2011, Jason Davies, Jason Davies, 20, 6, 26, 0, 49
Tue Oct 11 05:40:52 BST 2011, Mike Bostock, Mike Bostock, 83, 0, 83, 0, 26
Tue Oct 11 05:40:10 BST 2011, Mike Bostock, Mike Bostock, 364, 91, 455, 0, 22
Tue Oct 11 05:39:00 BST 2011, Mike Bostock, Mike Bostock, 115, 37, 152, 0, 37
Tue Oct 11 05:38:26 BST 2011, Mike Bostock, Mike Bostock, 60, 3, 63, 0, 36
Tue Oct 11 05:37:56 BST 2011, Mike Bostock, Mike Bostock, 134, 2, 136, 0, 32
Tue Oct 11 05:13:25 BST 2011, Mike Bostock, Mike Bostock, 104, 148, 252, 3, 233
Tue Oct 11 01:54:46 BST 2011, Mike Bostock, Mike Bostock, 132, 10, 142, 0, 80
Tue Oct 11 01:50:17 BST 2011, Mike Bostock, Mike Bostock, 60, 3, 63, 0, 79
Tue Oct 11 01:49:53 BST 2011, Mike Bostock, Mike Bostock, 67, 6, 73, 0, 14
Tue Oct 11 01:41:52 BST 2011, Mike Bostock, Mike Bostock, 73, 2, 75, 0, 66
Tue Oct 11 00:45:08 BST 2011, Mike Bostock, Mike Bostock, 55, 49, 104, 0, 265
Sat Oct 08 18:19:01 BST 2011, Jason Davies, Jason Davies, 41, 18, 59, 0, 173
Sat Oct 08 17:30:17 BST 2011, Jason Davies, Jason Davies, 37, 3, 40, 0, 519
Sat Oct 08 17:45:47 BST 2011, Mike Bostock, Mike Bostock, 7, 6, 13, 0, 66
Sat Oct 08 13:58:41 BST 2011, Jason Davies, Jason Davies, working on the server, 1, 0, 1, 0, 278
Sat Oct 08 12:42:45 BST 2011, Jason Davies, Jason Davies, 2, 2, 4, 0, 47
Sat Oct 08 00:09:59 BST 2011, Jason Davies, Jason Davies, 4, 4, 8, 0, 174
Fri Oct 07 23:37:51 BST 2011, Mike Bostock, Mike Bostock, 17, 13, 30, 0, 37
Fri Oct 07 21:57:59 BST 2011, Jason Davies, Jason Davies, 62, 2, 64, 0, 68
Fri Oct 07 20:23:55 BST 2011, Mike Bostock, Mike Bostock, 311, 183, 494, 0, 22
Fri Oct 07 20:19:30 BST 2011, Mike Bostock, Mike Bostock, 28, 22, 50, 0, 11
Fri Oct 07 20:18:33 BST 2011, Mike Bostock, Mike Bostock, 53, 4, 57, 0, 72
Fri Oct 07 20:17:17 BST 2011, Mike Bostock, Mike Bostock, 96, 34, 130, 0, 127
Fri Oct 07 20:16:15 BST 2011, Mike Bostock, Mike Bostock, 33, 22, 55, 0, 49
Fri Oct 07 20:10:10 BST 2011, Mike Bostock, Mike Bostock, 10, 6, 16, 0, 344
Fri Oct 07 19:32:06 BST 2011, Mike Bostock, Mike Bostock, 33, 22, 55, 0, 250
Fri Oct 07 17:40:58 BST 2011, Jason Davies, Jason Davies, 93, 98, 191, 0, 128
Thu Oct 06 20:34:06 BST 2011, Jason Davies, Jason Davies, 13, 13, 26, 0, 189
Thu Oct 06 20:06:14 BST 2011, Jason Davies, Jason Davies, 61, 49, 110, 0, 84
Thu Oct 06 16:45:49 BST 2011, Mike Bostock, Mike Bostock, 13, 16, 29, 0, 93
Thu Oct 06 09:56:34 BST 2011, Jason Davies, Jason Davies, 6, 6, 12, 0, 19
Thu Oct 06 09:54:07 BST 2011, Jason Davies, Jason Davies, 49, 31, 80, 0, 68
Wed Oct 05 23:05:42 BST 2011, Jason Davies, Jason Davies, 14, 13, 27, 0, 47
Wed Oct 05 22:38:30 BST 2011, Jason Davies, Jason Davies, 3, 3, 6, 0, 35
Wed Oct 05 22:35:19 BST 2011, Jason Davies, Jason Davies, 36, 5, 41, 0, 43
Tue Oct 04 19:34:16 BST 2011, Lars Kotthoff, Lars Kotthoff, 13, 21, 34, 0, 55
Mon Oct 03 21:07:38 BST 2011, Lars Kotthoff, Lars Kotthoff, 6, 1, 7, 0, 523
Mon Oct 03 19:49:44 BST 2011, Lars Kotthoff, Lars Kotthoff, 2, 1, 3, 0, 237
Sat Oct 01 02:00:42 BST 2011, Mike Bostock, Mike Bostock, 661, 0, 661, 0, 23
Fri Sep 30 17:01:24 BST 2011, Mike Bostock, Mike Bostock, 661, 0, 661, 0, 22
Fri Sep 30 17:02:11 BST 2011, Mike Bostock, Mike Bostock, 22, 2, 24, 0, 91
Fri Sep 30 17:00:55 BST 2011, Mike Bostock, Mike Bostock, 4, 0, 4, 0, 106
Fri Sep 30 16:55:30 BST 2011, Jason Davies, Jason Davies, 4, 0, 4, 0, 113
Fri Sep 30 08:48:28 BST 2011, Jason Davies, Jason Davies, 2, 3, 5, 0, 9
Fri Sep 30 08:43:22 BST 2011, Jason Davies, Jason Davies, 23, 2, 25, 0, 116
Fri Sep 30 07:51:33 BST 2011, Jason Davies, Jason Davies, 17, 23, 40, 0, 35
Fri Sep 30 05:53:22 BST 2011, Mike Bostock, Mike Bostock, 125, 111, 236, 0, 37
Thu Sep 29 22:59:56 BST 2011, Mike Bostock, Mike Bostock, 15, 11, 26, 2, 43
Thu Sep 29 16:33:34 BST 2011, Jason Davies, Jason Davies, 5, 7, 12, 0, 44
Wed Sep 28 21:10:59 BST 2011, Jason Davies, Jason Davies, 61, 4, 65, 0, 58
Wed Sep 28 23:28:36 BST 2011, Mike Bostock, Mike Bostock, 70, 0, 70, 0, 99
Tue Sep 27 23:00:27 BST 2011, Mike Bostock, Mike Bostock, 1649, 618, 2267, 0, 22
Tue Sep 27 22:58:39 BST 2011, Mike Bostock, Mike Bostock, 161, 84, 245, 0, 40
Tue Sep 27 21:57:56 BST 2011, Mike Bostock, Mike Bostock, 340, 1, 341, 0, 70
Tue Sep 27 21:56:18 BST 2011, Mike Bostock, Mike Bostock, 1122, 572, 1694, 0, 36
Tue Sep 27 21:56:07 BST 2011, Mike Bostock, Mike Bostock, 5, 4, 9, 0, 50
Tue Sep 27 21:55:35 BST 2011, Mike Bostock, Mike Bostock, 64, 21, 85, 0, 43
Tue Sep 27 21:54:58 BST 2011, Mike Bostock, Mike Bostock, 3, 1, 4, 0, 45
Tue Sep 27 21:54:36 BST 2011, Mike Bostock, Mike Bostock, 26, 10, 36, 0, 79
Tue Sep 27 21:45:34 BST 2011, Mike Bostock, Mike Bostock, 7, 3, 10, 0, 29
Tue Sep 27 21:53:17 BST 2011, Mike Bostock, Mike Bostock, 5, 4, 9, 0, 65
Tue Sep 27 21:53:05 BST 2011, Mike Bostock, Mike Bostock, 6, 8, 14, 0, 78
Tue Sep 27 20:27:17 BST 2011, Mike Bostock, Mike Bostock, 83, 15, 98, 0, 29
Tue Sep 27 20:14:06 BST 2011, Mike Bostock, Mike Bostock, 29, 39, 68, 0, 38
Tue Sep 27 20:13:40 BST 2011, Mike Bostock, Mike Bostock, 54, 1, 55, 0, 83
Tue Sep 27 20:06:48 BST 2011, Mike Bostock, Mike Bostock, 3, 3, 6, 0, 38
Tue Sep 27 20:06:23 BST 2011, Mike Bostock, Mike Bostock, 6, 6, 12, 0, 48
Tue Sep 27 19:55:47 BST 2011, Mike Bostock, Mike Bostock, 191, 250, 441, 0, 299
Tue Sep 27 16:58:52 BST 2011, Mike Bostock, Mike Bostock, 261, 244, 505, 0, 177
Tue Sep 27 16:47:14 BST 2011, Mike Bostock, Mike Bostock, 55, 11, 66, 0, 22
Tue Sep 27 16:45:06 BST 2011, Mike Bostock, Mike Bostock, 54, 10, 64, 0, 244
Tue Sep 27 16:26:41 BST 2011, Mike Bostock, Mike Bostock, 4, 4, 8, 0, 69
Tue Sep 27 08:51:00 BST 2011, Mike Bostock, Mike Bostock, 3, 3, 6, 0, 38
Tue Sep 27 08:34:22 BST 2011, Mike Bostock, Mike Bostock, 547, 556, 1103, 0, 488
Tue Sep 27 08:31:22 BST 2011, Mike Bostock, Mike Bostock, 1, 1, 2, 0, 91
Tue Sep 27 00:36:46 BST 2011, Mike Bostock, Mike Bostock, 607, 117, 724, 0, 74
Mon Sep 26 13:20:04 BST 2011, Jason Davies, Jason Davies, 6, 8, 14, 0, 168
Mon Sep 26 02:37:51 BST 2011, Jason Davies, Jason Davies, 71, 7, 78, 0, 59
Sun Sep 25 23:40:28 BST 2011, Jason Davies, Jason Davies, 276, 1, 277, 0, 199
Sat Sep 24 23:47:06 BST 2011, Johan Sundström, Johan Sundström, 5, 4, 9, 0, 58
Thu Sep 22 23:50:30 BST 2011, Jason Davies, Jason Davies, 7, 7, 14, 0, 49
Thu Sep 22 23:22:08 BST 2011, Jason Davies, Jason Davies, 32, 16, 48, 0, 583
Wed Sep 21 23:32:19 BST 2011, Mike Bostock, Mike Bostock, 64, 21, 85, 4, 307
Wed Sep 21 18:10:47 BST 2011, Mike Bostock, Mike Bostock, 20, 5, 25, 0, 47
Wed Sep 21 18:08:39 BST 2011, Mike Bostock, Mike Bostock, 13, 14, 27, 0, 269
Wed Sep 21 02:14:00 BST 2011, Peter Woodman, Peter Woodman, 2, 1, 3, 0, 48
Wed Sep 21 01:23:55 BST 2011, Peter Woodman, Peter Woodman, 5, 3, 8, 0, 85
Wed Sep 21 01:10:42 BST 2011, Peter Woodman, Peter Woodman, 7, 7, 14, 0, 117
Wed Sep 21 00:38:52 BST 2011, Mike Bostock, Mike Bostock, 3, 4, 7, 0, 37
Wed Sep 21 00:20:06 BST 2011, Peter Woodman, Peter Woodman, 127, 10, 137, 0, 37
Tue Sep 20 11:05:09 BST 2011, Peter Woodman, Peter Woodman, 2, 0, 2, 0, 81
Tue Sep 20 20:19:04 BST 2011, Mike Bostock, Mike Bostock, 3, 1, 4, 0, 110
Mon Sep 19 09:18:35 BST 2011, Jason Davies, Jason Davies, 4, 4, 8, 0, 542
Sun Sep 18 13:43:24 BST 2011, Jason Davies, Jason Davies, 15, 0, 15, 0, 32
Sun Sep 18 10:46:32 BST 2011, Jason Davies, Jason Davies, 5, 5, 10, 0, 232
Sun Sep 18 04:35:40 BST 2011, Mike Bostock, Mike Bostock, 453, 128, 581, 0, 22
Sun Sep 18 04:32:04 BST 2011, Mike Bostock, Mike Bostock, 53, 38, 91, 0, 38
Sun Sep 18 04:09:00 BST 2011, Mike Bostock, Mike Bostock, 24, 13, 37, 0, 67
Sun Sep 18 04:07:56 BST 2011, Mike Bostock, Mike Bostock, 38, 4, 42, 0, 72
Sun Sep 18 04:05:09 BST 2011, Mike Bostock, Mike Bostock, 85, 27, 112, 0, 69
Sun Sep 18 03:17:09 BST 2011, Mike Bostock, Mike Bostock, 18, 42, 60, 0, 97
Sun Sep 18 03:04:02 BST 2011, Mike Bostock, Mike Bostock, 138, 22, 160, 0, 83
Sun Sep 18 03:03:16 BST 2011, Mike Bostock, Mike Bostock, 26, 34, 60, 0, 41
Sun Sep 18 03:02:34 BST 2011, Mike Bostock, Mike Bostock, 124, 27, 151, 0, 45
Thu Sep 15 19:03:28 BST 2011, Lars Kotthoff, Lars Kotthoff, 26, 0, 26, 0, 30
Thu Sep 15 01:15:38 BST 2011, yasirs, yasirs, 7, 7, 14, 0, 29
Thu Sep 15 01:13:31 BST 2011, yasirs, yasirs, 4, 4, 8, 0, 55
Wed Sep 14 22:08:25 BST 2011, yasirs, yasirs, 1, 5, 6, 0, 44
Wed Sep 14 22:04:48 BST 2011, yasirs, yasirs, 2, 3, 5, 0, 27
Wed Sep 14 22:01:08 BST 2011, yasirs, yasirs, 15, 7, 22, 0, 28
Wed Sep 14 21:54:40 BST 2011, yasirs, yasirs, 3, 3, 6, 0, 33
Wed Sep 14 21:47:07 BST 2011, yasirs, yasirs, 4, 3, 7, 0, 38
Wed Sep 14 21:38:46 BST 2011, yasirs, yasirs, 8, 14, 22, 0, 179
Wed Sep 14 21:23:53 BST 2011, yasirs, yasirs, 8, 4, 12, 0, 17
Wed Sep 14 21:17:30 BST 2011, yasirs, yasirs, 13, 10, 23, 0, 28
Wed Sep 14 19:58:18 BST 2011, yasirs, yasirs, 9, 3, 12, 0, 63
Wed Sep 14 19:15:50 BST 2011, Mike Bostock, Mike Bostock, 26, 34, 60, 0, 18
Mon Sep 12 17:32:36 BST 2011, Jason Davies, Jason Davies, 30, 12, 42, 0, 109
Mon Sep 12 17:23:32 BST 2011, Jason Davies, Jason Davies, 61, 61, 122, 0, 68
Mon Sep 12 15:23:30 BST 2011, Jason Davies, Jason Davies, 63, 59, 122, 0, 192
Mon Sep 12 14:10:45 BST 2011, Jason Davies, Jason Davies, 5, 7, 12, 0, 108
Mon Sep 12 13:47:23 BST 2011, Jason Davies, Jason Davies, 2, 2, 4, 0, 44
Mon Sep 12 13:45:04 BST 2011, Jason Davies, Jason Davies, 54, 14, 68, 0, 42
Mon Sep 12 13:14:37 BST 2011, Jason Davies, Jason Davies, 59, 61, 120, 0, 109
Mon Sep 12 11:53:37 BST 2011, Jason Davies, Jason Davies, 163, 119, 282, 0, 477
Mon Sep 12 10:56:24 BST 2011, Jason Davies, Jason Davies, 11, 9, 20, 0, 49
Mon Sep 12 10:21:54 BST 2011, Jason Davies, Jason Davies, 5, 9, 14, 0, 43
Sat Sep 10 15:37:39 BST 2011, Jason Davies, Jason Davies, 264, 26, 290, 0, 441
Mon Sep 12 01:36:16 BST 2011, Mike Bostock, Mike Bostock, 1, 1, 2, 0, 37
Sat Sep 10 13:42:45 BST 2011, Jason Davies, Jason Davies, 46, 4, 50, 0, 42
Sat Sep 10 13:34:19 BST 2011, Jason Davies, Jason Davies, 59, 7, 66, 0, 42
Sat Sep 10 12:50:08 BST 2011, Jason Davies, Jason Davies, 69, 11, 80, 0, 87
Fri Sep 09 23:41:35 BST 2011, Mike Bostock, Mike Bostock, 805, 3, 808, 0, 100
Fri Sep 09 23:37:59 BST 2011, Jason Davies, Jason Davies, 805, 3, 808, 0, 50
Fri Sep 09 08:20:55 BST 2011, Jason Davies, Jason Davies, 3, 3, 6, 0, 45
Thu Sep 08 09:12:38 BST 2011, Jason Davies, Jason Davies, 11, 0, 11, 0, 45
Thu Sep 08 09:04:13 BST 2011, Jason Davies, Jason Davies, 10, 0, 10, 0, 43
Thu Sep 08 09:00:24 BST 2011, Jason Davies, Jason Davies, 39, 0, 39, 0, 49
Thu Sep 08 07:09:51 BST 2011, Jason Davies, Jason Davies, 56, 21, 77, 0, 112
Thu Sep 08 00:26:44 BST 2011, Jason Davies, Jason Davies, 26, 5, 31, 0, 62
Wed Sep 07 08:55:37 BST 2011, Jason Davies, Jason Davies, 7, 5, 12, 0, 19
Sat Sep 03 22:23:08 BST 2011, Jason Davies, Jason Davies, 17, 5, 22, 0, 39
Sat Sep 03 21:48:19 BST 2011, Jason Davies, Jason Davies, 7, 7, 14, 0, 19
Fri Sep 02 19:57:59 BST 2011, Mike Bostock, Mike Bostock, 6, 6, 12, 0, 78
Fri Sep 02 11:52:24 BST 2011, Jason Davies, Jason Davies, 75, 25, 100, 0, 102
Thu Sep 01 01:50:48 BST 2011, Mike Bostock, Mike Bostock, 58, 46, 104, 0, 22
Thu Sep 01 01:50:07 BST 2011, Mike Bostock, Mike Bostock, 48, 36, 84, 0, 38
Wed Aug 31 12:48:01 BST 2011, Jason Davies, Jason Davies, 10, 10, 20, 0, 38
Tue Aug 30 21:07:41 BST 2011, Mike Bostock, Mike Bostock, 48, 36, 84, 0, 321
Tue Aug 30 00:38:12 BST 2011, Mike Bostock, Mike Bostock, 109, 0, 109, 0, 32
Mon Aug 29 20:13:19 BST 2011, Mike Bostock, Mike Bostock, 6, 6, 12, 0, 38
Mon Aug 29 19:58:09 BST 2011, Mike Bostock, Mike Bostock, 2, 2, 4, 0, 47
Mon Aug 29 19:56:58 BST 2011, Mike Bostock, Mike Bostock, 656, 124, 780, 0, 22
Mon Aug 29 19:54:21 BST 2011, Mike Bostock, Mike Bostock, 280, 9, 289, 0, 75
Mon Aug 29 19:53:22 BST 2011, Mike Bostock, Mike Bostock, 226, 1, 227, 0, 76
Mon Aug 29 19:52:45 BST 2011, Mike Bostock, Mike Bostock, 28, 19, 47, 0, 37
Mon Aug 29 19:52:22 BST 2011, Mike Bostock, Mike Bostock, 6, 6, 12, 0, 44
Mon Aug 29 19:51:58 BST 2011, Mike Bostock, Mike Bostock, 61, 41, 102, 0, 51
Mon Aug 29 19:51:27 BST 2011, Mike Bostock, Mike Bostock, 55, 48, 103, 0, 33
Mon Aug 29 18:03:31 BST 2011, Jason Davies, Jason Davies, 37, 37, 74, 0, 48
Mon Aug 29 16:46:58 BST 2011, Mike Bostock, Mike Bostock, 2, 2, 4, 0, 98
Mon Aug 29 01:33:17 BST 2011, Jason Davies, Jason Davies, 125, 56, 181, 0, 221
Mon Aug 29 11:40:56 BST 2011, Jason Davies, Jason Davies, 2, 2, 4, 0, 280
Mon Aug 29 03:35:53 BST 2011, Mike Bostock, Mike Bostock, 28, 19, 47, 1, 473
Mon Aug 29 02:28:22 BST 2011, Mike Bostock, Mike Bostock, 5, 5, 10, 0, 217
Mon Aug 29 01:10:52 BST 2011, Mike Bostock, Mike Bostock, 5, 5, 10, 0, 43
Sun Aug 28 23:20:58 BST 2011, Mike Bostock, Mike Bostock, 61, 41, 102, 0, 251
Sun Aug 28 17:32:52 BST 2011, Mike Bostock, Mike Bostock, 43, 39, 82, 0, 529
Sun Aug 28 16:59:35 BST 2011, Jason Davies, Jason Davies, 157, 1, 158, 0, 414
Sat Aug 27 19:49:32 BST 2011, Mike Bostock, Mike Bostock, 23, 20, 43, 0, 385
Sat Aug 27 19:38:03 BST 2011, Mike Bostock, Mike Bostock, 13, 5, 18, 0, 110
Sat Aug 27 18:59:24 BST 2011, Mike Bostock, Mike Bostock, 1, 1, 2, 0, 84
Sat Aug 27 18:54:50 BST 2011, Jason Davies, Jason Davies, 18, 18, 36, 0, 50
Sat Aug 27 18:48:47 BST 2011, Jason Davies, Jason Davies, 3, 3, 6, 0, 43
Sat Aug 27 18:45:26 BST 2011, Jason Davies, Jason Davies, 19, 19, 38, 0, 168
Sat Aug 27 12:00:27 BST 2011, Jason Davies, Jason Davies, 278, 7, 285, 0, 80
Sat Aug 27 01:00:23 BST 2011, Mike Bostock, Mike Bostock, 195, 95, 290, 0, 22
Sat Aug 27 00:58:45 BST 2011, Mike Bostock, Mike Bostock, 114, 47, 161, 0, 49
Sat Aug 27 00:58:15 BST 2011, Mike Bostock, Mike Bostock, 37, 34, 71, 0, 42
Sat Aug 27 00:57:34 BST 2011, Mike Bostock, Mike Bostock, 10, 10, 20, 0, 40
Sat Aug 27 00:54:12 BST 2011, Mike Bostock, Mike Bostock, 35, 5, 40, 0, 81
Sat Aug 27 00:50:29 BST 2011, Mike Bostock, Mike Bostock, 114, 47, 161, 0, 421
Fri Aug 26 21:29:21 BST 2011, Jason Davies, Jason Davies, 1, 1, 2, 0, 153
Fri Aug 26 21:17:27 BST 2011, Mike Bostock, Mike Bostock, 37, 34, 71, 0, 265
Fri Aug 26 18:46:01 BST 2011, Jason Davies, Jason Davies, 35, 5, 40, 0, 77
Fri Aug 26 00:36:40 BST 2011, Jason Davies, Jason Davies, 23, 7, 30, 0, 42
Thu Aug 25 17:13:45 BST 2011, Mike Bostock, Mike Bostock, 10, 10, 20, 0, 235
Thu Aug 25 02:11:35 BST 2011, Mike Bostock, Mike Bostock, 12, 10, 22, 0, 21
Thu Aug 25 02:04:29 BST 2011, Mike Bostock, Mike Bostock, 274, 57, 331, 0, 22
Thu Aug 25 02:01:13 BST 2011, Mike Bostock, Mike Bostock, 3, 3, 6, 0, 39
Thu Aug 25 01:56:34 BST 2011, Mike Bostock, Mike Bostock, 181, 0, 181, 0, 31
Thu Aug 25 01:46:10 BST 2011, Mike Bostock, Mike Bostock, 16, 2, 18, 0, 170
Thu Aug 25 00:20:59 BST 2011, Mike Bostock, Mike Bostock, 9, 3, 12, 0, 42
Thu Aug 25 00:11:28 BST 2011, Mike Bostock, Mike Bostock, 33, 21, 54, 0, 194
Thu Aug 25 00:04:47 BST 2011, Mike Bostock, Mike Bostock, 34, 30, 64, 0, 337
Wed Aug 24 22:12:59 BST 2011, Mike Bostock, Mike Bostock, 96, 86, 182, 0, 22
Wed Aug 24 22:11:52 BST 2011, Mike Bostock, Mike Bostock, 8, 4, 12, 0, 78
Wed Aug 24 22:08:19 BST 2011, Mike Bostock, Mike Bostock, 88, 82, 170, 0, 295
Wed Aug 24 18:28:14 BST 2011, Jason Davies, Jason Davies, 8, 4, 12, 0, 43
Tue Aug 23 21:09:39 BST 2011, Mike Bostock, Mike Bostock, 8, 1, 9, 0, 76
Tue Aug 23 20:53:21 BST 2011, Mike Bostock, Mike Bostock, 7920, 3140, 11060, 0, 22
Tue Aug 23 20:51:44 BST 2011, Mike Bostock, Mike Bostock, 7451, 2757, 10208, 0, 32
Tue Aug 23 20:47:46 BST 2011, Mike Bostock, Mike Bostock, 469, 383, 852, 0, 327
Tue Aug 23 20:02:12 BST 2011, Mike Bostock, Mike Bostock, 202, 215, 417, 0, 413
Tue Aug 23 19:07:18 BST 2011, Mike Bostock, Mike Bostock, 65, 41, 106, 0, 47
Tue Aug 23 18:37:38 BST 2011, Mike Bostock, Mike Bostock, 177, 45, 222, 0, 17
Tue Aug 23 17:06:39 BST 2011, Xavier Shay, Xavier Shay, 15, 1, 16, 0, 37
Tue Aug 23 17:06:00 BST 2011, Xavier Shay, Xavier Shay, 9, 8, 17, 0, 48
Tue Aug 23 16:38:18 BST 2011, Mike Bostock, Mike Bostock, 9, 0, 9, 0, 16
Tue Aug 23 11:07:23 BST 2011, Jason Davies, Jason Davies, 20, 2, 22, 0, 43
Tue Aug 23 07:01:53 BST 2011, Mike Bostock, Mike Bostock, 6, 6, 12, 0, 94
Tue Aug 23 06:53:51 BST 2011, Mike Bostock, Mike Bostock, 225, 102, 327, 0, 34
Tue Aug 23 02:50:14 BST 2011, Mike Bostock, Mike Bostock, 35, 15, 50, 0, 55
Tue Aug 23 02:05:41 BST 2011, Mike Bostock, Mike Bostock, 12, 6, 18, 0, 35
Tue Aug 23 01:28:45 BST 2011, Mike Bostock, Mike Bostock, 109, 7, 116, 0, 506
Tue Aug 23 00:35:23 BST 2011, Mike Bostock, Mike Bostock, 67, 22, 89, 0, 17
Tue Aug 23 00:20:54 BST 2011, Mike Bostock, Mike Bostock, 86, 48, 134, 0, 31
Mon Aug 22 22:20:54 BST 2011, Mike Bostock, Mike Bostock, 1, 2, 3, 0, 25
Mon Aug 22 22:08:18 BST 2011, Mike Bostock, Mike Bostock, 85, 46, 131, 0, 22
Mon Aug 22 22:05:06 BST 2011, Mike Bostock, Mike Bostock, 44, 7, 51, 0, 75
Mon Aug 22 22:03:32 BST 2011, Mike Bostock, Mike Bostock, 25, 23, 48, 0, 33
Mon Aug 22 22:03:19 BST 2011, Mike Bostock, Mike Bostock, 2, 2, 4, 0, 70
Mon Aug 22 21:48:21 BST 2011, Jason Davies, Jason Davies, 44, 7, 51, 0, 195
Mon Aug 22 21:43:41 BST 2011, Mike Bostock, Mike Bostock, 15, 9, 24, 0, 520
Mon Aug 22 21:23:26 BST 2011, Jason Davies, Jason Davies, 11, 11, 22, 0, 21
Mon Aug 22 20:40:45 BST 2011, Mike Bostock, Mike Bostock, 11, 15, 26, 0, 272
Thu Aug 18 20:21:47 BST 2011, Jason Davies, Jason Davies, 269, 175, 444, 0, 275
Mon Aug 22 19:33:13 BST 2011, Mike Bostock, Mike Bostock, 2, 2, 4, 0, 23
Mon Aug 22 19:26:40 BST 2011, Mike Bostock, Mike Bostock, 211, 257, 468, 0, 244
Mon Aug 22 05:07:29 BST 2011, Mike Bostock, Mike Bostock, 407, 353, 760, 0, 29
Mon Aug 22 04:34:22 BST 2011, Mike Bostock, Mike Bostock, 57, 25, 82, 0, 21
Mon Aug 22 01:50:22 BST 2011, Mike Bostock, Mike Bostock, 73, 2, 75, 0, 30
Mon Aug 22 01:43:37 BST 2011, Mike Bostock, Mike Bostock, 32, 10, 42, 0, 33
Mon Aug 22 01:36:24 BST 2011, Mike Bostock, Mike Bostock, 49, 1, 50, 0, 34
Mon Aug 22 01:28:32 BST 2011, Mike Bostock, Mike Bostock, 57, 1, 58, 0, 31
Mon Aug 22 01:16:57 BST 2011, Mike Bostock, Mike Bostock, 154, 10, 164, 0, 39
Sun Aug 21 23:54:17 BST 2011, Mike Bostock, Mike Bostock, 61, 13, 74, 0, 231
Sun Aug 21 23:21:57 BST 2011, Mike Bostock, Mike Bostock, 35, 2, 37, 0, 29
Sun Aug 21 23:19:09 BST 2011, Mike Bostock, Mike Bostock, 31, 1, 32, 0, 29
Sun Aug 21 23:01:31 BST 2011, Mike Bostock, Mike Bostock, 101, 2, 103, 0, 44
Sun Aug 21 07:50:34 BST 2011, Mike Bostock, Mike Bostock, 248, 39, 287, 0, 481
Sun Aug 21 01:04:50 BST 2011, Mike Bostock, Mike Bostock, 8, 14, 22, 0, 28
Sun Aug 21 01:04:04 BST 2011, Mike Bostock, Mike Bostock, 32, 32, 64, 0, 62
Sun Aug 21 00:27:25 BST 2011, Mike Bostock, Mike Bostock, 1540, 1652, 3192, 0, 1607
Sat Aug 20 14:38:46 BST 2011, Jason Davies, Jason Davies, 2, 2, 4, 0, 22
Fri Aug 19 23:22:46 BST 2011, Mike Bostock, Mike Bostock, 259, 61, 320, 0, 91
Fri Aug 19 22:45:56 BST 2011, Mike Bostock, Mike Bostock, 18, 5, 23, 0, 30
Fri Aug 19 22:44:23 BST 2011, Mike Bostock, Mike Bostock, 82, 4, 86, 0, 43
Fri Aug 19 22:26:39 BST 2011, Mike Bostock, Mike Bostock, 254, 1, 255, 0, 245
Fri Aug 19 22:02:47 BST 2011, Mike Bostock, Mike Bostock, 2516, 0, 2516, 0, 17
Fri Aug 19 21:57:06 BST 2011, Mike Bostock, Mike Bostock, 12, 8, 20, 0, 37
Fri Aug 19 21:56:02 BST 2011, Mike Bostock, Mike Bostock, 33, 16, 49, 0, 38
Fri Aug 19 21:55:43 BST 2011, Mike Bostock, Mike Bostock, 15082, 44983, 60065, 0, 39
Fri Aug 19 19:02:39 BST 2011, Mike Bostock, Mike Bostock, 33, 16, 49, 0, 22
Fri Aug 19 19:01:12 BST 2011, Mike Bostock, Mike Bostock, 26, 5, 31, 0, 63
Fri Aug 19 18:57:46 BST 2011, Mike Bostock, Mike Bostock, 3, 3, 6, 0, 47
Fri Aug 19 18:56:37 BST 2011, Mike Bostock, Mike Bostock, 4, 6, 10, 0, 11
Fri Aug 19 18:55:48 BST 2011, Mike Bostock, Mike Bostock, 7, 9, 16, 0, 70
Fri Aug 19 18:10:29 BST 2011, Mike Bostock, Mike Bostock, 3, 3, 6, 0, 40
Fri Aug 19 11:13:22 BST 2011, Jason Davies, Jason Davies, 7, 9, 16, 0, 125
Thu Aug 18 22:59:55 BST 2011, Mike Bostock, Mike Bostock, 1099, 661, 1760, 0, 38
Thu Aug 18 20:44:31 BST 2011, Mike Bostock, Mike Bostock, 9308, 46627, 55935, 0, 38
Thu Aug 18 18:14:34 BST 2011, Mike Bostock, Mike Bostock, 169, 0, 169, 0, 19
Thu Aug 18 17:54:50 BST 2011, Mike Bostock, Mike Bostock, 42, 8, 50, 0, 178
Thu Aug 18 00:24:19 BST 2011, Mike Bostock, Mike Bostock, 1499, 3457, 4956, 0, 19
Thu Aug 18 00:22:20 BST 2011, Mike Bostock, Mike Bostock, 3, 3, 6, 5, 37
Thu Aug 18 00:13:50 BST 2011, Mike Bostock, Mike Bostock, 8, 4, 12, 0, 45
Thu Aug 18 00:07:28 BST 2011, Mike Bostock, Mike Bostock, 222, 11, 233, 0, 95
Wed Aug 17 22:58:49 BST 2011, Mike Bostock, Mike Bostock, 214, 78, 292, 0, 46
Wed Aug 17 22:24:54 BST 2011, Mike Bostock, Mike Bostock, 90, 0, 90, 0, 29
Wed Aug 17 22:09:34 BST 2011, Mike Bostock, Mike Bostock, 164, 65, 229, 0, 26
Wed Aug 17 21:27:55 BST 2011, Mike Bostock, Mike Bostock, 135, 16, 151, 0, 87
Wed Aug 17 21:13:37 BST 2011, Mike Bostock, Mike Bostock, 4, 3204, 3208, 0, 112
Wed Aug 17 07:11:52 BST 2011, Mike Bostock, Mike Bostock, 75, 0, 75, 0, 32
Wed Aug 17 06:51:32 BST 2011, Mike Bostock, Mike Bostock, 74, 5, 79, 0, 28
Wed Aug 17 06:39:02 BST 2011, Mike Bostock, Mike Bostock, 40, 1, 41, 0, 24
Wed Aug 17 06:30:46 BST 2011, Mike Bostock, Mike Bostock, 38, 0, 38, 0, 17
Wed Aug 17 06:28:15 BST 2011, Mike Bostock, Mike Bostock, 378, 72, 450, 0, 30
Wed Aug 17 05:21:16 BST 2011, Mike Bostock, Mike Bostock, 74, 18, 92, 0, 165
Tue Aug 16 20:31:00 BST 2011, Mike Bostock, Mike Bostock, 462, 11, 473, 0, 19
Tue Aug 16 20:26:47 BST 2011, Mike Bostock, Mike Bostock, 133, 4, 137, 0, 18
Tue Aug 16 19:32:32 BST 2011, Mike Bostock, Mike Bostock, 116, 0, 116, 0, 22
Tue Aug 16 19:16:53 BST 2011, Mike Bostock, Mike Bostock, 109, 6, 115, 0, 137
Tue Aug 16 18:59:34 BST 2011, Mike Bostock, Mike Bostock, 50, 0, 50, 0, 22
Tue Aug 16 18:51:55 BST 2011, Mike Bostock, Mike Bostock, 56, 3, 59, 0, 67
Tue Aug 16 06:22:18 BST 2011, Mike Bostock, Mike Bostock, 240, 8, 248, 0, 19
Tue Aug 16 06:19:58 BST 2011, Mike Bostock, Mike Bostock, 38, 0, 38, 0, 20
Tue Aug 16 05:47:14 BST 2011, Mike Bostock, Mike Bostock, 29, 0, 29, 0, 21
Tue Aug 16 05:41:03 BST 2011, Mike Bostock, Mike Bostock, 34, 0, 34, 0, 19
Tue Aug 16 05:29:55 BST 2011, Mike Bostock, Mike Bostock, 27, 0, 27, 0, 19
Tue Aug 16 05:23:34 BST 2011, Mike Bostock, Mike Bostock, 110, 6, 116, 0, 105
Tue Aug 16 00:45:54 BST 2011, Mike Bostock, Mike Bostock, 7136, 43383, 50519, 0, 22
Tue Aug 16 00:43:59 BST 2011, Mike Bostock, Mike Bostock, 39, 0, 39, 0, 30
Tue Aug 16 00:39:11 BST 2011, Mike Bostock, Mike Bostock, 3, 3, 6, 0, 95
Tue Aug 16 00:28:48 BST 2011, Mike Bostock, Mike Bostock, 2, 37114, 37116, 0, 48
Tue Aug 16 00:25:39 BST 2011, Mike Bostock, Mike Bostock, 64, 247, 311, 0, 28
Tue Aug 16 00:02:41 BST 2011, Mike Bostock, Mike Bostock, 166, 89, 255, 0, 24
Mon Aug 15 23:53:46 BST 2011, Mike Bostock, Mike Bostock, 176, 146, 322, 0, 23
Mon Aug 15 23:42:01 BST 2011, Mike Bostock, Mike Bostock, 76, 140, 216, 0, 27
Mon Aug 15 23:30:26 BST 2011, Mike Bostock, Mike Bostock, 13, 66, 79, 0, 34
Mon Aug 15 23:22:39 BST 2011, Mike Bostock, Mike Bostock, 139, 188, 327, 0, 23
Mon Aug 15 23:12:54 BST 2011, Mike Bostock, Mike Bostock, 141, 210, 351, 0, 102
Mon Aug 15 22:12:17 BST 2011, Mike Bostock, Mike Bostock, 155, 128, 283, 0, 89
Mon Aug 15 21:32:34 BST 2011, Mike Bostock, Mike Bostock, 91, 41, 132, 0, 30
Mon Aug 15 21:07:28 BST 2011, Mike Bostock, Mike Bostock, 96, 106, 202, 0, 24
Mon Aug 15 20:55:42 BST 2011, Mike Bostock, Mike Bostock, 83, 143, 226, 0, 22
Mon Aug 15 20:50:20 BST 2011, Mike Bostock, Mike Bostock, 95, 188, 283, 0, 22
Mon Aug 15 20:16:14 BST 2011, Mike Bostock, Mike Bostock, 67, 18, 85, 0, 21
Mon Aug 15 19:40:42 BST 2011, Mike Bostock, Mike Bostock, 471, 1340, 1811, 0, 44
Mon Aug 15 05:50:20 BST 2011, Mike Bostock, Mike Bostock, 156, 303, 459, 0, 32
Mon Aug 15 05:30:17 BST 2011, Mike Bostock, Mike Bostock, 122, 72, 194, 0, 29
Mon Aug 15 05:28:10 BST 2011, Mike Bostock, Mike Bostock, 119, 72, 191, 0, 25
Mon Aug 15 05:03:01 BST 2011, Mike Bostock, Mike Bostock, 35, 12, 47, 0, 29
Mon Aug 15 04:55:11 BST 2011, Mike Bostock, Mike Bostock, 73, 72, 145, 0, 24
Mon Aug 15 04:54:48 BST 2011, Mike Bostock, Mike Bostock, 41, 36, 77, 0, 23
Mon Aug 15 04:47:20 BST 2011, Mike Bostock, Mike Bostock, 105, 85, 190, 0, 24
Mon Aug 15 04:38:02 BST 2011, Mike Bostock, Mike Bostock, 59, 36, 95, 0, 23
Mon Aug 15 04:29:08 BST 2011, Mike Bostock, Mike Bostock, 101, 70, 171, 0, 26
Mon Aug 15 04:23:23 BST 2011, Mike Bostock, Mike Bostock, 41, 36, 77, 0, 25
Mon Aug 15 04:18:58 BST 2011, Mike Bostock, Mike Bostock, 64, 0, 64, 0, 38
Mon Aug 15 04:02:49 BST 2011, Mike Bostock, Mike Bostock, 89, 68, 157, 0, 25
Mon Aug 15 03:51:53 BST 2011, Mike Bostock, Mike Bostock, 53, 36, 89, 0, 24
Mon Aug 15 03:38:02 BST 2011, Mike Bostock, Mike Bostock, 87, 64, 151, 0, 26
Mon Aug 15 03:22:27 BST 2011, Mike Bostock, Mike Bostock, 35, 1, 36, 0, 34
Mon Aug 15 03:16:56 BST 2011, Mike Bostock, Mike Bostock, 43, 32, 75, 0, 25
Mon Aug 15 02:59:01 BST 2011, Mike Bostock, Mike Bostock, 85, 80, 165, 0, 24
Mon Aug 15 02:14:59 BST 2011, Mike Bostock, Mike Bostock, 103, 113, 216, 0, 23
Mon Aug 15 01:20:28 BST 2011, Mike Bostock, Mike Bostock, 67, 38, 105, 0, 22
Mon Aug 15 01:01:15 BST 2011, Mike Bostock, Mike Bostock, 89, 65, 154, 0, 23
Sun Aug 14 22:37:24 BST 2011, Mike Bostock, Mike Bostock, 104, 30, 134, 0, 51
Sun Aug 14 21:07:20 BST 2011, Mike Bostock, Mike Bostock, 44, 24, 68, 0, 24
Sun Aug 14 20:57:09 BST 2011, Mike Bostock, Mike Bostock, 236, 376, 612, 0, 18
Sun Aug 14 19:52:59 BST 2011, Mike Bostock, Mike Bostock, 203, 150, 353, 0, 25
Sun Aug 14 19:16:03 BST 2011, Mike Bostock, Mike Bostock, 90, 96, 186, 0, 17
Sun Aug 14 18:44:58 BST 2011, Mike Bostock, Mike Bostock, 101, 93, 194, 0, 17
Sun Aug 14 18:11:37 BST 2011, Mike Bostock, Mike Bostock, 200, 366, 566, 0, 20
Sun Aug 14 17:29:42 BST 2011, Mike Bostock, Mike Bostock, 70, 141, 211, 0, 19
Sun Aug 14 17:11:33 BST 2011, Mike Bostock, Mike Bostock, 53, 65, 118, 0, 21
Sun Aug 14 17:03:00 BST 2011, Mike Bostock, Mike Bostock, 43, 0, 43, 0, 21
Sun Aug 14 07:13:10 BST 2011, Mike Bostock, Mike Bostock, 38, 3, 41, 0, 23
Sun Aug 14 07:09:37 BST 2011, Mike Bostock, Mike Bostock, 31, 23, 54, 0, 18
Sun Aug 14 07:00:24 BST 2011, Mike Bostock, Mike Bostock, 47, 56, 103, 0, 20
Sun Aug 14 06:54:08 BST 2011, Mike Bostock, Mike Bostock, 32, 39, 71, 0, 17
Sun Aug 14 06:45:02 BST 2011, Mike Bostock, Mike Bostock, 100, 148, 248, 0, 26
Sun Aug 14 03:25:54 BST 2011, Mike Bostock, Mike Bostock, 2, 2, 4, 0, 15
Sun Aug 14 03:10:38 BST 2011, Mike Bostock, Mike Bostock, 87, 0, 87, 0, 26
Sun Aug 14 02:47:23 BST 2011, Mike Bostock, Mike Bostock, 0, 62, 62, 0, 39
Sun Aug 14 02:46:20 BST 2011, Mike Bostock, Mike Bostock, 39, 0, 39, 0, 30
Sun Aug 14 02:40:38 BST 2011, Mike Bostock, Mike Bostock, 79, 2, 81, 0, 38
Sun Aug 14 02:22:13 BST 2011, Mike Bostock, Mike Bostock, 122, 0, 122, 0, 30
Sun Aug 14 02:15:14 BST 2011, Mike Bostock, Mike Bostock, 28, 1, 29, 0, 26
Sun Aug 14 02:08:34 BST 2011, Mike Bostock, Mike Bostock, 9, 0, 9, 0, 41
Sun Aug 14 02:05:02 BST 2011, Mike Bostock, Mike Bostock, 162, 2, 164, 0, 28
Sun Aug 14 02:04:34 BST 2011, Mike Bostock, Mike Bostock, 18, 0, 18, 0, 24
Sun Aug 14 01:33:45 BST 2011, Mike Bostock, Mike Bostock, 74, 0, 74, 0, 45
Sun Aug 14 01:27:54 BST 2011, Mike Bostock, Mike Bostock, 70, 0, 70, 0, 28
Sun Aug 14 00:45:10 BST 2011, Mike Bostock, Mike Bostock, 115, 0, 115, 0, 28
Sat Aug 13 22:43:04 BST 2011, Mike Bostock, Mike Bostock, 103, 0, 103, 0, 28
Sat Aug 13 22:23:02 BST 2011, Mike Bostock, Mike Bostock, 77, 0, 77, 0, 28
Sat Aug 13 19:36:39 BST 2011, Mike Bostock, Mike Bostock, 50, 0, 50, 0, 28
Sat Aug 13 19:34:41 BST 2011, Mike Bostock, Mike Bostock, 51, 0, 51, 0, 29
Sat Aug 13 19:28:40 BST 2011, Mike Bostock, Mike Bostock, 47, 0, 47, 0, 27
Sat Aug 13 19:13:38 BST 2011, Mike Bostock, Mike Bostock, 65, 0, 65, 0, 34
Sat Aug 13 19:00:52 BST 2011, Mike Bostock, Mike Bostock, 53, 0, 53, 0, 26
Sat Aug 13 18:48:01 BST 2011, Mike Bostock, Mike Bostock, 187, 63, 250, 0, 31
Sat Aug 13 18:26:24 BST 2011, Mike Bostock, Mike Bostock, 65, 31, 96, 0, 28
Sat Aug 13 18:19:14 BST 2011, Mike Bostock, Mike Bostock, 0, 119, 119, 0, 28
Sat Aug 13 18:18:49 BST 2011, Mike Bostock, Mike Bostock, 0, 61, 61, 0, 37
Sat Aug 13 18:18:40 BST 2011, Mike Bostock, Mike Bostock, 103, 0, 103, 0, 28
Sat Aug 13 07:58:56 BST 2011, Mike Bostock, Mike Bostock, 98, 0, 98, 0, 47
Sat Aug 13 07:26:46 BST 2011, Mike Bostock, Mike Bostock, 219, 24, 243, 0, 45
Sat Aug 13 05:52:45 BST 2011, Mike Bostock, Mike Bostock, 54, 96, 150, 0, 38
Sat Aug 13 05:52:10 BST 2011, Mike Bostock, Mike Bostock, 207, 0, 207, 0, 46
Sat Aug 13 05:50:50 BST 2011, Mike Bostock, Mike Bostock, 63, 0, 63, 0, 30
Sat Aug 13 05:42:40 BST 2011, Mike Bostock, Mike Bostock, 53, 0, 53, 0, 19
Sat Aug 13 02:07:42 BST 2011, Mike Bostock, Mike Bostock, 148, 0, 148, 0, 41
Sat Aug 06 17:09:27 BST 2011, Mike Bostock, Mike Bostock, 207, 143, 350, 0, 329
Thu Aug 11 09:22:40 BST 2011, Mitsutoshi Aoe, Mitsutoshi Aoe, 0, 0, 0, 0, 117
Mon Aug 08 03:51:41 BST 2011, Mitsutoshi Aoe, Mitsutoshi Aoe, 3, 2, 5, 0, 21
Mon Aug 08 03:50:47 BST 2011, Mitsutoshi Aoe, Mitsutoshi Aoe, 2, 1, 3, 0, 36
Wed Aug 10 02:52:52 BST 2011, Mike Bostock + Erica Kwan, Mike Bostock + Erica Kwan, 3, 2, 5, 0, 43
Tue Aug 09 20:29:17 BST 2011, Mike Bostock, Mike Bostock, 8, 9, 17, 0, 17
Tue Aug 09 19:25:00 BST 2011, Mike Bostock, Mike Bostock, 70, 0, 70, 0, 33
Tue Aug 09 19:24:48 BST 2011, Mike Bostock, Mike Bostock, 123, 0, 123, 0, 36
Mon Aug 08 03:51:41 BST 2011, Mitsutoshi Aoe, Mitsutoshi Aoe, 3, 2, 5, 0, 21
Mon Aug 08 03:50:47 BST 2011, Mitsutoshi Aoe, Mitsutoshi Aoe, 2, 1, 3, 0, 36
Mon Aug 01 22:38:46 BST 2011, Mike Bostock, Mike Bostock, 738, 0, 738, 0, 23
Mon Aug 01 19:25:42 BST 2011, Mike Bostock, Mike Bostock, 221, 73, 294, 0, 22
Mon Aug 01 19:23:26 BST 2011, Mike Bostock, Mike Bostock, 15, 29, 44, 0, 45
Mon Aug 01 19:16:38 BST 2011, Mike Bostock, Mike Bostock, 206, 44, 250, 0, 42
Mon Aug 01 01:31:24 BST 2011, Mike Bostock, Mike Bostock, 457, 114, 571, 0, 19
Mon Aug 01 01:28:04 BST 2011, Mike Bostock, Mike Bostock, 454, 111, 565, 0, 412
Mon Aug 01 01:11:34 BST 2011, Mike Bostock, Mike Bostock, 23, 5, 28, 0, 29
Mon Aug 01 00:14:21 BST 2011, Mike Bostock, Mike Bostock, 0, 1, 1, 0, 15
Mon Aug 01 00:11:35 BST 2011, Mike Bostock, Mike Bostock, 24, 9, 33, 0, 22
Mon Aug 01 00:09:13 BST 2011, Mike Bostock, Mike Bostock, 21, 8, 29, 0, 43
Wed Jul 27 18:03:40 BST 2011, Jason Davies, Jason Davies, 5, 3, 8, 0, 207
Thu Jul 21 00:15:57 BST 2011, Mike Bostock, Mike Bostock, 2896, 166, 3062, 0, 22
Wed Jul 20 23:24:27 BST 2011, Mike Bostock, Mike Bostock, 2582, 140, 2722, 0, 32
Wed Jul 20 23:21:09 BST 2011, Mike Bostock, Mike Bostock, 45, 3, 48, 0, 94
Wed Jul 20 23:11:07 BST 2011, Mike Bostock, Mike Bostock, 124, 123, 247, 0, 42
Wed Jul 20 21:56:44 BST 2011, Mike Bostock, Mike Bostock, 848, 75, 923, 0, 161
Wed Jul 20 20:50:06 BST 2011, Mike Bostock, Mike Bostock, 32, 32, 64, 0, 29
Wed Jul 20 09:07:14 BST 2011, Jason Davies, Jason Davies, 56, 0, 56, 0, 30
Wed Jul 20 08:07:44 BST 2011, Jason Davies, Jason Davies, 18, 3, 21, 0, 31
Wed Jul 20 01:08:40 BST 2011, Mike Bostock, Mike Bostock, 866, 3, 869, 0, 18
Tue Jul 19 23:47:00 BST 2011, Jason Davies, Jason Davies, 10, 10, 20, 0, 50
Tue Jul 19 23:45:15 BST 2011, Jason Davies, Jason Davies, 7, 23, 30, 0, 83
Tue Jul 19 23:07:05 BST 2011, Jason Davies, Jason Davies, 78, 3, 81, 0, 45
Tue Jul 19 22:45:57 BST 2011, Jason Davies, Jason Davies, 107, 43, 150, 0, 45
Tue Jul 19 21:58:44 BST 2011, Jason Davies, Jason Davies, 7, 7, 14, 0, 45
Tue Jul 19 21:02:01 BST 2011, Jason Davies, Jason Davies, 86, 35, 121, 0, 172
Tue Jul 19 02:08:06 BST 2011, Mike Bostock, Mike Bostock, 185, 185, 370, 0, 28
Tue Jul 19 01:56:30 BST 2011, Mike Bostock, Mike Bostock, 808, 2, 810, 0, 37
Sun Jul 17 04:45:11 BST 2011, Mike Bostock, Mike Bostock, 44, 24, 68, 0, 22
Sun Jul 17 04:42:49 BST 2011, Mike Bostock, Mike Bostock, 3, 3, 6, 0, 20
Sun Jul 17 04:42:18 BST 2011, Mike Bostock, Mike Bostock, 1, 1, 2, 0, 65
Sun Jul 17 04:41:26 BST 2011, Mike Bostock, Mike Bostock, 5, 5, 10, 0, 72
Sun Jul 17 04:40:57 BST 2011, Mike Bostock, Mike Bostock, 4, 4, 8, 0, 74
Sun Jul 17 04:40:29 BST 2011, Mike Bostock, Mike Bostock, 17, 5, 22, 0, 81
Sun Jul 17 04:39:09 BST 2011, Mike Bostock, Mike Bostock, 13, 7, 20, 0, 72
Sun Jul 17 04:37:08 BST 2011, Mike Bostock, Mike Bostock, 2, 1, 3, 0, 23
Sat Jul 16 18:16:41 BST 2011, Jason Davies, Jason Davies, 5, 5, 10, 0, 9
Sat Jul 16 00:49:25 BST 2011, Jason Davies, Jason Davies, 4, 4, 8, 0, 19
Fri Jul 15 00:39:34 BST 2011, Tommy Montgomery, Tommy Montgomery, 1, 1, 2, 0, 76
Thu Jul 14 10:02:43 BST 2011, Jason Davies, Jason Davies, 17, 5, 22, 0, 391
Tue Jul 12 18:29:55 BST 2011, Jason Davies, Jason Davies, 11, 9, 20, 0, 183
Tue Jul 12 17:32:20 BST 2011, Jason Davies, Jason Davies, 7, 15, 22, 0, 207
Tue Jul 12 16:48:27 BST 2011, Jason Davies, Jason Davies, 3, 3, 6, 0, 40
Tue Jul 12 16:42:12 BST 2011, Jason Davies, Jason Davies, 13, 3, 16, 0, 41
Tue Jul 12 04:53:57 BST 2011, Caged, Caged, 1, 0, 1, 0, 63
Sun Jul 10 18:28:38 BST 2011, Mike Bostock, Mike Bostock, 304, 290, 594, 0, 168
Sun Jul 10 05:00:51 BST 2011, Mike Bostock, Mike Bostock, 718, 329, 1047, 0, 22
Sun Jul 10 04:30:14 BST 2011, Mike Bostock, Mike Bostock, 263, 173, 436, 1, 259
Sun Jul 10 00:03:07 BST 2011, Mike Bostock, Mike Bostock, 11, 13, 24, 0, 32
Sat Jul 09 23:55:44 BST 2011, Mike Bostock, Mike Bostock, 130, 85, 215, 0, 535
Sat Jul 09 23:15:14 BST 2011, Mike Bostock, Mike Bostock, 37, 30, 67, 0, 16
Sat Jul 09 22:45:19 BST 2011, Mike Bostock, Mike Bostock, 277, 28, 305, 0, 31
Sat Jul 09 06:44:41 BST 2011, Mike Bostock, Mike Bostock, 407, 41, 448, 0, 22
Sat Jul 09 06:43:05 BST 2011, Mike Bostock, Mike Bostock, 389, 23, 412, 0, 42
Sat Jul 09 06:42:26 BST 2011, Mike Bostock, Mike Bostock, 15, 15, 30, 0, 24
Sat Jul 09 06:39:34 BST 2011, Mike Bostock, Mike Bostock, 104, 0, 104, 0, 31
Sat Jul 09 06:39:08 BST 2011, Mike Bostock, Mike Bostock, 15, 9, 24, 0, 37
Sat Jul 09 00:24:17 BST 2011, Jason Davies, Jason Davies, 14, 36, 50, 0, 94
Fri Jul 08 23:23:50 BST 2011, Jason Davies, Jason Davies, 77, 23, 100, 0, 321
Fri Jul 08 22:55:23 BST 2011, Jason Davies, Jason Davies, 7, 1, 8, 0, 45
Fri Jul 08 22:41:01 BST 2011, Jason Davies, Jason Davies, 84, 0, 84, 0, 93
Fri Jul 08 22:19:28 BST 2011, Jason Davies, Jason Davies, 7, 3, 10, 0, 35
Fri Jul 08 22:11:49 BST 2011, Jason Davies, Jason Davies, 31, 35, 66, 0, 46
Fri Jul 08 21:55:31 BST 2011, Jason Davies, Jason Davies, 88, 0, 88, 0, 193
Fri Jul 08 21:23:41 BST 2011, Jason Davies, Jason Davies, 15, 3, 18, 0, 115
Fri Jul 08 21:20:38 BST 2011, Jason Davies, Jason Davies, 39, 17, 56, 0, 181
Fri Jul 08 21:11:34 BST 2011, Jason Davies, Jason Davies, 3, 3, 6, 0, 79
Fri Jul 08 20:57:17 BST 2011, Jason Davies, Jason Davies, 19, 7, 26, 0, 55
Thu Jul 07 16:47:36 BST 2011, Ignacio, Ignacio, 7, 7, 14, 0, 41
Wed Jul 06 23:19:45 BST 2011, Jason Davies, Jason Davies, 0, 1, 1, 0, 38
Wed Jul 06 20:29:17 BST 2011, Jason Davies, Jason Davies, 2, 4, 6, 0, 36
Wed Jul 06 19:54:58 BST 2011, Jason Davies, Jason Davies, 5209, 1055, 6264, 0, 87
Wed Jul 06 19:52:32 BST 2011, Jason Davies, Jason Davies, 0, 5, 5, 0, 47
Wed Jul 06 18:57:14 BST 2011, Jason Davies, Jason Davies, 75, 326, 401, 4, 48
Mon Jul 04 17:43:37 BST 2011, Mike Bostock, Mike Bostock, 3, 6, 9, 0, 16
Mon Jul 04 17:41:32 BST 2011, Mike Bostock, Mike Bostock, 3, 3, 6, 0, 43
Mon Jul 04 17:38:25 BST 2011, Mike Bostock, Mike Bostock, 3, 3, 6, 0, 76
Mon Jul 04 08:05:56 BST 2011, Jan Alonzo, Jan Alonzo, 3, 3, 6, 0, 151
Sun Jul 03 15:59:09 BST 2011, Mike Bostock, Mike Bostock, 11, 7, 18, 0, 16
Sun Jul 03 15:46:07 BST 2011, Mike Bostock, Mike Bostock, 135, 3, 138, 0, 25
Sun Jul 03 01:16:57 BST 2011, Mike Bostock, Mike Bostock, 650, 434, 1084, 0, 24
Sun Jul 03 01:14:34 BST 2011, Mike Bostock, Mike Bostock, 46, 24, 70, 0, 258
Sun Jul 03 00:38:00 BST 2011, Mike Bostock, Mike Bostock, 139, 0, 139, 0, 20
Sun Jul 03 00:36:59 BST 2011, Mike Bostock, Mike Bostock, 6, 5, 11, 0, 28
Sun Jul 03 00:31:12 BST 2011, Mike Bostock, Mike Bostock, 431, 388, 819, 0, 279
Sat Jul 02 23:59:19 BST 2011, Mike Bostock, Mike Bostock, 18, 49, 67, 0, 48
Sat Jul 02 23:49:50 BST 2011, Mike Bostock, Mike Bostock, 86, 62, 148, 0, 183
Sat Jul 02 22:49:31 BST 2011, Mike Bostock, Mike Bostock, 25, 7, 32, 0, 232
Sat Jul 02 16:49:05 BST 2011, Mike Bostock, Mike Bostock, 5, 5, 10, 0, 30
Sat Jul 02 16:48:16 BST 2011, Mike Bostock, Mike Bostock, 2, 2, 4, 0, 76
Thu Jun 30 02:50:42 BST 2011, Mike Bostock, Mike Bostock, 58, 4, 62, 0, 146
Tue Jun 28 21:27:03 BST 2011, Mike Bostock, Mike Bostock, 167, 133, 300, 0, 263
Tue Jun 28 00:06:59 BST 2011, vtstarin, vtstarin, 2, 2, 4, 0, 38
Sun Jun 26 01:31:02 BST 2011, Nathan Vander Wilt, Nathan Vander Wilt, 1, 1, 2, 0, 16
Sat Jun 25 21:26:32 BST 2011, Mike Bostock, Mike Bostock, 1, 2, 3, 0, 21
Sat Jun 25 18:48:31 BST 2011, Mike Bostock, Mike Bostock, 13, 19, 32, 0, 46
Sat Jun 25 18:41:38 BST 2011, Mike Bostock, Mike Bostock, 110, 0, 110, 0, 35
Fri Jun 24 04:52:17 BST 2011, Mike Bostock, Mike Bostock, 1091, 164, 1255, 0, 22
Fri Jun 24 04:50:36 BST 2011, Mike Bostock, Mike Bostock, 895, 64, 959, 0, 32
Fri Jun 24 04:49:33 BST 2011, Mike Bostock, Mike Bostock, 107, 66, 173, 0, 23
Fri Jun 24 04:17:06 BST 2011, Mike Bostock, Mike Bostock, 720, 13, 733, 0, 31
Fri Jun 24 04:03:27 BST 2011, Mike Bostock, Mike Bostock, 99, 39, 138, 0, 76
Fri Jun 24 03:53:28 BST 2011, Mike Bostock, Mike Bostock, 41, 10, 51, 0, 57
Sun Jun 12 07:10:42 BST 2011, Mike Bostock, Mike Bostock, 4, 12, 16, 0, 34
Fri Jun 24 03:45:23 BST 2011, Mike Bostock, Mike Bostock, 139, 119, 258, 0, 459
Thu Jun 23 19:28:55 BST 2011, Mike Bostock, Mike Bostock, 56, 70, 126, 0, 364
Thu Jun 23 18:40:39 BST 2011, Mike Bostock, Mike Bostock, 7, 7, 14, 0, 28
Thu Jun 23 01:09:31 BST 2011, Mike Bostock, Mike Bostock, 57, 72, 129, 0, 44
Thu Jun 23 00:49:01 BST 2011, Mike Bostock, Mike Bostock, 1, 1, 2, 0, 18
Thu Jun 23 00:42:14 BST 2011, Mike Bostock, Mike Bostock, 4, 14, 18, 0, 31
Wed Jun 22 22:33:34 BST 2011, Mike Bostock, Mike Bostock, 51, 12, 63, 0, 27
Wed Jun 22 21:17:18 BST 2011, Mike Bostock, Mike Bostock, 94, 11, 105, 0, 23
Wed Jun 22 20:01:23 BST 2011, Jason Davies, Jason Davies, 15, 5, 20, 0, 347
Wed Jun 22 19:45:40 BST 2011, Jason Davies, Jason Davies, 2, 23, 25, 0, 297
Wed Jun 22 18:56:58 BST 2011, Jason Davies, Jason Davies, 23, 2, 25, 0, 230
Wed Jun 22 18:25:57 BST 2011, Mike Bostock, Mike Bostock, 10, 4, 14, 0, 36
Wed Jun 22 17:46:52 BST 2011, Mike Bostock, Mike Bostock, 164, 189, 353, 0, 1037
Wed Jun 22 09:11:23 BST 2011, Jason Davies, Jason Davies, 168, 33, 201, 0, 94
Sat Jun 18 11:19:06 BST 2011, Jason Davies, Jason Davies, 28, 0, 28, 0, 30
Fri Jun 17 21:18:40 BST 2011, Jason Davies, Jason Davies, 66, 18, 84, 0, 60
Fri Jun 17 18:39:56 BST 2011, Jason Davies, Jason Davies, 2, 11, 13, 0, 16
Fri Jun 17 16:59:34 BST 2011, Jason Davies, Jason Davies, 508, 1, 509, 0, 125
Fri Jun 17 14:42:23 BST 2011, Jason Davies, Jason Davies, 41, 10, 51, 0, 131
Fri Jun 17 05:12:37 BST 2011, Mike Bostock, Mike Bostock, 502, 51, 553, 0, 22
Fri Jun 17 05:11:31 BST 2011, Mike Bostock, Mike Bostock, 9, 2, 11, 0, 36
Fri Jun 17 05:09:41 BST 2011, Mike Bostock, Mike Bostock, 122, 36, 158, 0, 31
Wed Jun 15 23:20:14 BST 2011, Jason Davies, Jason Davies, 9, 2, 11, 0, 261
Wed Jun 15 18:59:15 BST 2011, Mike Bostock, Mike Bostock, 28, 0, 28, 0, 33
Wed Jun 15 18:50:46 BST 2011, Mike Bostock, Mike Bostock, 73, 64, 137, 0, 37
Wed Jun 15 18:48:20 BST 2011, Mike Bostock, Mike Bostock, 145, 0, 145, 0, 39
Wed Jun 15 17:47:54 BST 2011, Jason Davies, Jason Davies, 34, 34, 68, 0, 34
Wed Jun 15 17:44:58 BST 2011, Jason Davies, Jason Davies, 88, 2, 90, 0, 24
Wed Jun 15 08:16:46 BST 2011, Mike Bostock, Mike Bostock, 187, 11, 198, 0, 27
Tue Jun 14 01:37:57 BST 2011, Mike Bostock, Mike Bostock, 29, 29, 58, 0, 22
Tue Jun 14 01:34:20 BST 2011, Mike Bostock, Mike Bostock, 5, 5, 10, 0, 46
Tue Jun 14 01:32:49 BST 2011, Mike Bostock, Mike Bostock, 13, 13, 26, 0, 259
Tue Jun 14 01:30:30 BST 2011, Mike Bostock, Mike Bostock, 8, 8, 16, 0, 17
Mon Jun 13 23:54:24 BST 2011, Kevin J. Lynagh, Kevin J. Lynagh, 1, 1, 2, 0, 106
Sun Jun 12 22:07:08 BST 2011, Mike Bostock, Mike Bostock, 322, 0, 322, 0, 19
Sun Jun 12 21:16:55 BST 2011, Jason Davies, Jason Davies, 237, 476, 713, 0, 189
Sun Jun 12 21:13:43 BST 2011, Jason Davies, Jason Davies, 14, 27, 41, 0, 45
Sun Jun 12 21:11:48 BST 2011, Mike Bostock, Mike Bostock, 68, 0, 68, 0, 29
Sun Jun 12 20:59:02 BST 2011, Mike Bostock, Mike Bostock, 14, 27, 41, 0, 28
Sun Jun 12 20:41:21 BST 2011, Jason Davies, Jason Davies, 43, 43, 86, 0, 30
Sat Jun 11 12:49:21 BST 2011, Jason Davies, Jason Davies, 574, 0, 574, 0, 77
Sun Jun 12 02:11:15 BST 2011, Mike Bostock, Mike Bostock, 10, 10, 20, 0, 29
Sun Jun 12 01:15:35 BST 2011, Mike Bostock, Mike Bostock, 4, 3, 7, 0, 12
Sun Jun 12 00:59:42 BST 2011, Mike Bostock, Mike Bostock, 119, 0, 119, 0, 26
Sat Jun 11 23:56:18 BST 2011, Mike Bostock, Mike Bostock, 12, 8, 20, 0, 490
Sat Jun 11 21:00:28 BST 2011, Mike Bostock, Mike Bostock, 4, 3, 7, 0, 34
Sat Jun 11 20:57:35 BST 2011, Mike Bostock, Mike Bostock, 281, 24, 305, 0, 27
Sat Jun 11 20:54:44 BST 2011, Mike Bostock, Mike Bostock, 105, 193, 298, 0, 278
Sat Jun 11 20:49:22 BST 2011, Mike Bostock, Mike Bostock, 398, 103, 501, 0, 39
Sat Jun 11 20:40:43 BST 2011, Mike Bostock, Mike Bostock, 398, 103, 501, 0, 22
Sat Jun 11 20:38:50 BST 2011, Mike Bostock, Mike Bostock, 1, 1, 2, 0, 27
Sat Jun 11 20:37:23 BST 2011, Mike Bostock, Mike Bostock, 60, 18, 78, 0, 41
Sat Jun 11 20:36:51 BST 2011, Mike Bostock, Mike Bostock, 36, 0, 36, 0, 45
Sat Jun 11 20:31:13 BST 2011, Mike Bostock, Mike Bostock, 24, 18, 42, 0, 328
Sat Jun 11 20:20:57 BST 2011, Mike Bostock, Mike Bostock, 158, 2, 160, 0, 32
Sat Jun 11 20:20:34 BST 2011, Mike Bostock, Mike Bostock, 12, 12, 24, 0, 45
Sat Jun 11 20:17:47 BST 2011, Mike Bostock, Mike Bostock, 69, 98, 167, 0, 172
Sat Jun 11 19:31:42 BST 2011, Mike Bostock, Mike Bostock, 170, 73, 243, 0, 221
Sat Jun 11 19:12:51 BST 2011, Mike Bostock, Mike Bostock, 12, 12, 24, 0, 242
Tue Jun 07 17:46:25 BST 2011, Jason Davies, Jason Davies, 35, 57, 92, 0, 130
Tue Jun 07 17:32:55 BST 2011, Jason Davies, Jason Davies, 8, 8, 16, 0, 15
Tue Jun 07 09:45:56 BST 2011, Jason Davies, Jason Davies, 23, 15, 38, 0, 39
Tue Jun 07 09:31:23 BST 2011, Jason Davies, Jason Davies, 55, 3, 58, 0, 277
Tue Jun 07 08:44:02 BST 2011, Jason Davies, Jason Davies, 25, 10, 35, 0, 37
Tue Jun 07 06:51:16 BST 2011, Mike Bostock, Mike Bostock, 33, 15, 48, 0, 68
Tue Jun 07 06:50:10 BST 2011, Mike Bostock, Mike Bostock, 5, 3, 8, 0, 10
Tue Jun 07 06:38:08 BST 2011, Mike Bostock, Mike Bostock, 328, 109, 437, 0, 24
Tue Jun 07 05:59:18 BST 2011, chris viau, chris viau, 35, 16, 51, 0, 17
Tue Jun 07 03:55:18 BST 2011, chris viau, chris viau, 106, 0, 106, 0, 17
Tue Jun 07 00:38:41 BST 2011, Jason Davies, Jason Davies, 22, 10, 32, 0, 91
Tue Jun 07 00:29:45 BST 2011, Jason Davies, Jason Davies, 70, 2, 72, 0, 196
Mon Jun 06 23:51:05 BST 2011, Jason Davies, Jason Davies, 6, 3, 9, 0, 80
Mon Jun 06 23:40:04 BST 2011, Jason Davies, Jason Davies, 16, 1, 17, 0, 115
Mon Jun 06 23:34:16 BST 2011, Jason Davies, Jason Davies, 39, 2, 41, 0, 155
Mon Jun 06 18:48:00 BST 2011, Jason Davies, Jason Davies, 81, 17, 98, 0, 42
Mon Jun 06 17:54:22 BST 2011, Jason Davies, Jason Davies, 34, 3, 37, 0, 19
Mon Jun 06 08:57:35 BST 2011, Jason Davies, Jason Davies, 10, 30, 40, 0, 36
Fri Jun 03 07:25:28 BST 2011, Mike Bostock, Mike Bostock, 141, 2, 143, 0, 31
Thu Jun 02 20:17:41 BST 2011, Mike Bostock, Mike Bostock, 134, 0, 134, 0, 28
Mon May 30 21:39:32 BST 2011, Mike Bostock, Mike Bostock, 126, 66, 192, 0, 374
Mon May 30 17:31:19 BST 2011, Mike Bostock, Mike Bostock, 251, 4, 255, 0, 24
Mon May 30 17:29:34 BST 2011, Mike Bostock, Mike Bostock, 753, 144, 897, 0, 36
Mon May 30 17:26:23 BST 2011, Mike Bostock, Mike Bostock, 753, 144, 897, 0, 22
Mon May 30 17:23:45 BST 2011, Mike Bostock, Mike Bostock, 51, 27, 78, 0, 38
Mon May 30 17:23:39 BST 2011, Mike Bostock, Mike Bostock, 116, 22, 138, 0, 34
Mon May 30 17:22:28 BST 2011, Mike Bostock, Mike Bostock, 21, 21, 42, 0, 100
Mon May 30 17:09:39 BST 2011, Mike Bostock, Mike Bostock, 24, 10, 34, 0, 55
Mon May 30 10:09:53 BST 2011, Jason Davies, Jason Davies, 51, 27, 78, 0, 89
Mon May 30 09:43:47 BST 2011, Jason Davies, Jason Davies, 38, 14, 52, 0, 169
Mon May 30 09:38:17 BST 2011, Jason Davies, Jason Davies, 66, 10, 76, 0, 63
Sun May 29 06:57:18 BST 2011, Mike Bostock, Mike Bostock, 4579, 836, 5415, 0, 36
Sat May 28 08:13:53 BST 2011, Mike Bostock, Mike Bostock, 137, 134, 271, 0, 113
Sat May 28 06:26:29 BST 2011, Mike Bostock, Mike Bostock, 21, 5, 26, 0, 35
Fri May 27 23:48:54 BST 2011, Mike Bostock, Mike Bostock, 18, 11, 29, 0, 42
Fri May 27 22:58:06 BST 2011, Mike Bostock, Mike Bostock, 488, 80, 568, 0, 35
Fri May 27 22:54:56 BST 2011, Mike Bostock, Mike Bostock, 69, 2, 71, 0, 31
Fri May 27 22:54:15 BST 2011, Mike Bostock, Mike Bostock, 8, 8, 16, 0, 66
Fri May 27 22:46:59 BST 2011, Mike Bostock, Mike Bostock, 23, 23, 46, 1, 32
Fri May 27 20:34:08 BST 2011, Jason Davies, Jason Davies, 41, 12, 53, 0, 281
Fri May 27 09:36:36 BST 2011, Jason Davies, Jason Davies, 40, 2, 42, 0, 115
Fri May 27 05:15:28 BST 2011, Mike Bostock, Mike Bostock, 52, 53, 105, 0, 23
Thu May 26 08:10:14 BST 2011, Mike Bostock, Mike Bostock, 97, 27, 124, 0, 30
Mon May 23 21:09:04 BST 2011, Jason Davies, Jason Davies, 53, 19, 72, 0, 167
Thu May 19 22:31:34 BST 2011, Jason Davies, Jason Davies, 117, 83, 200, 0, 65
Mon May 23 09:45:34 BST 2011, Jason Davies, Jason Davies, 2564, 557, 3121, 0, 135
Sun May 22 19:26:46 BST 2011, Mike Bostock, Mike Bostock, 263, 160, 423, 0, 1363
Sun May 22 00:10:37 BST 2011, Jason Davies, Jason Davies, 8, 8, 16, 0, 103
Sun May 22 01:29:05 BST 2011, Mike Bostock, Mike Bostock, 1193, 89, 1282, 0, 22
Sun May 22 01:26:29 BST 2011, Mike Bostock, Mike Bostock, 428, 58, 486, 0, 34
Sun May 22 01:19:31 BST 2011, Mike Bostock, Mike Bostock, 13, 15, 28, 0, 444
Sun May 22 00:54:31 BST 2011, Mike Bostock, Mike Bostock, 40, 36, 76, 0, 36
Sun May 22 00:38:29 BST 2011, Mike Bostock, Mike Bostock, 141, 55, 196, 0, 478
Sat May 21 21:29:43 BST 2011, Jason Davies, Jason Davies, 21, 5, 26, 0, 50
Sat May 21 21:08:52 BST 2011, Mike Bostock, Mike Bostock, 7, 7, 14, 0, 17
Sat May 21 20:56:06 BST 2011, Mike Bostock, Mike Bostock, 596, 150, 746, 0, 287
Sat May 21 09:10:16 BST 2011, Jason Davies, Jason Davies, 278, 59, 337, 0, 104
Sat May 21 00:31:51 BST 2011, Mike Bostock, Mike Bostock, 1503, 391, 1894, 0, 36
Sat May 21 00:09:29 BST 2011, Mike Bostock, Mike Bostock, 7, 25, 32, 0, 67
Fri May 20 23:38:09 BST 2011, Mike Bostock, Mike Bostock, 134, 56, 190, 0, 330
Fri May 20 22:20:17 BST 2011, Mike Bostock, Mike Bostock, 155, 2, 157, 0, 13
Fri May 20 20:04:35 BST 2011, Jason Davies, Jason Davies, 27, 0, 27, 0, 41
Fri May 20 14:44:07 BST 2011, Jason Davies, Jason Davies, 16, 0, 16, 0, 18
Thu May 19 21:04:51 BST 2011, Jason Davies, Jason Davies, 28, 21, 49, 0, 84
Thu May 19 20:43:12 BST 2011, Jason Davies, Jason Davies, 132, 14, 146, 0, 278
Sat May 14 20:38:20 BST 2011, Jeffrey Heer, Jeffrey Heer, 12, 2, 14, 0, 33
Sat May 14 18:58:30 BST 2011, Jason Davies, Jason Davies, 25, 3, 28, 0, 8
Fri May 13 19:17:00 BST 2011, Jason Davies, Jason Davies, 167, 27, 194, 0, 201
Fri May 13 14:28:44 BST 2011, Jason Davies, Jason Davies, 29, 13, 42, 0, 44
Thu May 12 19:56:15 BST 2011, Mike Bostock, Mike Bostock, 418, 129, 547, 0, 22
Thu May 12 19:54:38 BST 2011, Mike Bostock, Mike Bostock, 99, 30, 129, 0, 104
Thu May 12 19:28:31 BST 2011, Mike Bostock, Mike Bostock, 3, 5, 8, 0, 31
Thu May 12 19:26:09 BST 2011, Mike Bostock, Mike Bostock, 49, 26, 75, 0, 33
Thu May 12 18:45:24 BST 2011, Mike Bostock, Mike Bostock, 229, 111, 340, 1, 733
Thu May 12 18:25:05 BST 2011, Mike Bostock, Mike Bostock, 83, 2, 85, 0, 15
Thu May 12 17:20:07 BST 2011, Jason Davies, Jason Davies, 10, 20, 30, 0, 199
Thu May 12 10:10:04 BST 2011, Jason Davies, Jason Davies, 20, 10, 30, 0, 111
Wed May 11 17:26:48 BST 2011, Jason Davies, Jason Davies, 49, 32, 81, 0, 42
Wed May 11 16:52:37 BST 2011, Jason Davies, Jason Davies, 4, 4, 8, 0, 160
Wed May 11 16:42:24 BST 2011, Jason Davies, Jason Davies, 15, 5, 20, 0, 64
Wed May 11 10:03:39 BST 2011, Jason Davies, Jason Davies, 24, 1, 25, 0, 18
Wed May 11 08:35:12 BST 2011, Jason Davies, Jason Davies, 50, 13, 63, 0, 31
Wed May 11 08:14:31 BST 2011, Jason Davies, Jason Davies, 3, 3, 6, 0, 45
Tue May 10 22:42:16 BST 2011, Jason Davies, Jason Davies, 9, 3, 12, 0, 362
Tue May 10 19:18:14 BST 2011, Jason Davies, Jason Davies, 3, 3, 6, 0, 31
Tue May 10 19:06:24 BST 2011, Jason Davies, Jason Davies, 136, 28, 164, 3, 428
Tue May 10 04:32:27 BST 2011, Mike Bostock, Mike Bostock, 1397, 103, 1500, 0, 33
Mon May 09 23:58:54 BST 2011, Jason Davies, Jason Davies, 334, 101, 435, 0, 178
Mon May 09 09:05:44 BST 2011, Jason Davies, Jason Davies, 7, 25, 32, 0, 23
Mon May 09 03:54:40 BST 2011, Mike Bostock, Mike Bostock, 164, 62, 226, 0, 25
Mon May 09 03:52:12 BST 2011, Mike Bostock, Mike Bostock, 2, 23, 25, 0, 94
Sun May 08 07:24:42 BST 2011, Mike Bostock, Mike Bostock, 6, 6, 12, 0, 18
Sun May 08 07:20:02 BST 2011, Mike Bostock, Mike Bostock, 144, 67, 211, 0, 252
Sun May 08 00:51:30 BST 2011, Mike Bostock, Mike Bostock, 942, 221, 1163, 0, 22
Sun May 08 00:47:46 BST 2011, Mike Bostock, Mike Bostock, 31, 1, 32, 0, 33
Sun May 08 00:42:59 BST 2011, Mike Bostock, Mike Bostock, 162, 160, 322, 0, 31
Sun May 08 00:39:46 BST 2011, Mike Bostock, Mike Bostock, 37, 7, 44, 0, 49
Sun May 08 00:35:30 BST 2011, Mike Bostock, Mike Bostock, 8, 6, 14, 0, 42
Sun May 08 00:34:01 BST 2011, Mike Bostock, Mike Bostock, 276, 7, 283, 0, 36
Sun May 08 00:31:03 BST 2011, Mike Bostock, Mike Bostock, 130, 84, 214, 0, 261
Sat May 07 19:28:48 BST 2011, Mike Bostock, Mike Bostock, 102, 14, 116, 0, 36
Sat May 07 19:27:48 BST 2011, Mike Bostock, Mike Bostock, 64, 0, 64, 0, 22
Sat May 07 19:21:59 BST 2011, Mike Bostock, Mike Bostock, 32, 34, 66, 0, 301
Sat May 07 19:09:28 BST 2011, Mike Bostock, Mike Bostock, 311, 35, 346, 0, 33
Sat May 07 19:08:48 BST 2011, Mike Bostock, Mike Bostock, 106, 12, 118, 0, 18
Sat May 07 18:59:49 BST 2011, Mike Bostock, Mike Bostock, 114, 92, 206, 0, 44
Sat May 07 18:32:17 BST 2011, Mike Bostock, Mike Bostock, 20, 14, 34, 0, 74
Thu May 05 21:46:49 BST 2011, Jason Davies, Jason Davies, 2, 2, 4, 0, 25
Thu May 05 21:44:40 BST 2011, Jason Davies, Jason Davies, 58, 12, 70, 0, 71
Thu May 05 21:25:45 BST 2011, Jason Davies, Jason Davies, 1, 1, 2, 0, 23
Thu May 05 18:51:53 BST 2011, Jason Davies, Jason Davies, 8, 6, 14, 0, 182
Thu May 05 17:27:43 BST 2011, Jason Davies, Jason Davies, 46, 16, 62, 0, 244
Thu May 05 16:25:49 BST 2011, Jason Davies, Jason Davies, 30, 24, 54, 0, 49
Thu May 05 16:20:54 BST 2011, Jason Davies, Jason Davies, 8, 14, 22, 0, 120
Thu May 05 14:32:26 BST 2011, Jason Davies, Jason Davies, 95, 49, 144, 0, 142
Thu May 05 13:27:33 BST 2011, Jason Davies, Jason Davies, 14, 8, 22, 0, 48
Thu May 05 13:23:04 BST 2011, Jason Davies, Jason Davies, 8, 2, 10, 0, 157
Thu May 05 12:32:14 BST 2011, Jason Davies, Jason Davies, 88, 4, 92, 0, 53
Wed May 04 00:23:09 BST 2011, Mike Bostock, Mike Bostock, 31, 1, 32, 0, 26
Tue May 03 17:27:02 BST 2011, Jason Davies, Jason Davies, 4, 4, 8, 0, 113
Tue May 03 17:17:03 BST 2011, Jason Davies, Jason Davies, 26, 12, 38, 0, 44
Tue May 03 13:38:56 BST 2011, Jason Davies, Jason Davies, 24, 6, 30, 0, 291
Tue May 03 12:20:48 BST 2011, Jason Davies, Jason Davies, 3, 3, 6, 0, 313
Tue May 03 11:26:43 BST 2011, Jason Davies, Jason Davies, 3, 5, 8, 0, 26
Tue May 03 02:51:36 BST 2011, Mike Bostock, Mike Bostock, 217, 1, 218, 0, 67
Tue May 03 02:46:08 BST 2011, Mike Bostock, Mike Bostock, 158, 5, 163, 0, 62
Tue May 03 02:42:39 BST 2011, Mike Bostock, Mike Bostock, 23, 4, 27, 0, 32
Tue May 03 01:11:44 BST 2011, Mike Bostock, Mike Bostock, 57, 4, 61, 0, 29
Sun May 01 16:08:24 BST 2011, Jason Davies, Jason Davies, 158, 5, 163, 0, 86
Mon May 02 00:15:09 BST 2011, Jason Davies, Jason Davies, 20, 0, 20, 0, 44
Sun May 01 09:48:01 BST 2011, Jason Davies, Jason Davies, 217, 1, 218, 0, 21
Sun May 01 23:31:25 BST 2011, Jason Davies, Jason Davies, 82, 80, 162, 0, 17
Sun May 01 23:31:01 BST 2011, Jason Davies, Jason Davies, 2, 2, 4, 3, 44
Sun May 01 20:31:34 BST 2011, Mike Bostock, Mike Bostock, 8, 4, 12, 0, 27
Sun May 01 18:24:38 BST 2011, Mike Bostock, Mike Bostock, 3, 4, 7, 0, 26
Sun May 01 18:22:45 BST 2011, Mike Bostock, Mike Bostock, 1, 2, 3, 0, 23
Sun May 01 17:58:46 BST 2011, Mike Bostock, Mike Bostock, 10, 8, 18, 0, 258
Sun May 01 05:53:01 BST 2011, Mike Bostock, Mike Bostock, 1255, 203, 1458, 0, 60
Sun May 01 05:52:14 BST 2011, Mike Bostock, Mike Bostock, 43, 35, 78, 2, 30
Sun May 01 05:18:52 BST 2011, Mike Bostock, Mike Bostock, 652, 4, 656, 0, 127
Sun May 01 05:16:58 BST 2011, Mike Bostock, Mike Bostock, 291, 356, 647, 0, 25
Sun May 01 00:50:45 BST 2011, Mike Bostock, Mike Bostock, 242, 93, 335, 0, 250
Sun May 01 00:47:38 BST 2011, Mike Bostock, Mike Bostock, 96, 88, 184, 1, 37
Sat Apr 30 23:58:56 BST 2011, Mike Bostock, Mike Bostock, 128, 0, 128, 0, 161
Sat Apr 30 23:56:03 BST 2011, Mike Bostock, Mike Bostock, 77, 78, 155, 0, 330
Sat Apr 30 21:19:28 BST 2011, Mike Bostock, Mike Bostock, 19, 1, 20, 0, 22
Sat Apr 30 21:13:51 BST 2011, Mike Bostock, Mike Bostock, 69, 69, 138, 0, 23
Fri Apr 29 17:14:44 BST 2011, Jason Davies, Jason Davies, 109, 0, 109, 0, 24
Fri Apr 29 16:09:56 BST 2011, Jason Davies, Jason Davies, 27, 8, 35, 0, 95
Fri Apr 29 15:14:55 BST 2011, Jason Davies, Jason Davies, 110, 0, 110, 0, 219
Fri Apr 29 10:14:15 BST 2011, Jason Davies, Jason Davies, 4, 9, 13, 0, 314
Fri Apr 29 10:02:28 BST 2011, Jason Davies, Jason Davies, 30, 37, 67, 0, 136
Thu Apr 28 19:43:26 BST 2011, Mike Bostock, Mike Bostock, 22, 12, 34, 0, 38
Thu Apr 28 18:23:04 BST 2011, Mike Bostock, Mike Bostock, 74, 88, 162, 0, 323
Thu Apr 28 00:24:31 BST 2011, Jason Davies, Jason Davies, 35, 11, 46, 0, 562
Wed Apr 27 23:46:49 BST 2011, Mike Bostock, Mike Bostock, 25, 21, 46, 0, 44
Wed Apr 27 18:30:47 BST 2011, Jason Davies, Jason Davies, 45, 41, 86, 0, 232
Wed Apr 27 18:23:54 BST 2011, Mike Bostock, Mike Bostock, 21, 7, 28, 0, 45
Tue Apr 26 12:10:48 BST 2011, Jason Davies, Jason Davies, 242, 93, 335, 0, 26
Wed Apr 27 01:26:21 BST 2011, Square, Square, 148, 46, 194, 0, 20
Wed Apr 27 01:20:07 BST 2011, Square, Square, 29, 39, 68, 0, 42
Wed Apr 27 01:19:43 BST 2011, Square, Square, 3, 3, 6, 0, 28
Wed Apr 27 00:53:54 BST 2011, Square, Square, 85, 13, 98, 0, 246
Tue Apr 26 23:50:22 BST 2011, Square, Square, 2, 0, 2, 0, 35
Tue Apr 26 23:42:06 BST 2011, Square, Square, 41, 21, 62, 0, 324
Tue Apr 26 23:03:10 BST 2011, Square, Square, 10, 8, 18, 0, 43
Tue Apr 26 22:40:21 BST 2011, Square, Square, 17, 1, 18, 0, 45
Tue Apr 26 22:35:46 BST 2011, Square, Square, 9, 9, 18, 0, 180
Mon Apr 25 12:59:11 BST 2011, Jason Davies, Jason Davies, 188, 3, 191, 0, 32
Sat Apr 23 11:39:35 BST 2011, Jason Davies, Jason Davies, 137, 135, 272, 0, 213
Sun Apr 24 10:18:03 BST 2011, Jason Davies, Jason Davies, 529, 1, 530, 0, 13
Mon Apr 25 06:35:59 BST 2011, Mike Bostock, Mike Bostock, 3, 3, 6, 0, 25
Mon Apr 25 06:34:47 BST 2011, Mike Bostock, Mike Bostock, 21, 27, 48, 0, 24
Mon Apr 25 06:33:56 BST 2011, Mike Bostock, Mike Bostock, 592, 252, 844, 0, 20
Mon Apr 25 06:29:36 BST 2011, Mike Bostock, Mike Bostock, 4, 4, 8, 0, 75
Mon Apr 25 06:09:48 BST 2011, Mike Bostock, Mike Bostock, 8, 8, 16, 0, 34
Sun Apr 24 20:13:40 BST 2011, Caged, Caged, 4, 4, 8, 0, 75
Fri Apr 22 22:28:03 BST 2011, Jason Davies, Jason Davies, 9066, 1463, 10529, 0, 57
Wed Apr 20 05:01:38 BST 2011, Mike Bostock, Mike Bostock, 53, 5, 58, 0, 40
Wed Apr 20 04:24:19 BST 2011, Mike Bostock, Mike Bostock, 21, 27, 48, 0, 355
Wed Apr 20 03:18:35 BST 2011, Mike Bostock, Mike Bostock, 57, 53, 110, 0, 232
Wed Apr 20 02:02:19 BST 2011, Mike Bostock, Mike Bostock, 14, 8, 22, 0, 377
Wed Apr 20 01:50:09 BST 2011, Mike Bostock, Mike Bostock, 64, 48, 112, 0, 584
Tue Apr 19 21:56:50 BST 2011, Mike Bostock, Mike Bostock, 3, 3, 6, 0, 23
Tue Apr 19 21:47:19 BST 2011, Mike Bostock, Mike Bostock, 231, 98, 329, 0, 528
Tue Apr 19 21:03:41 BST 2011, Mike Bostock, Mike Bostock, 27, 21, 48, 0, 662
Tue Apr 19 20:39:37 BST 2011, Mike Bostock, Mike Bostock, 220, 113, 333, 0, 567
Tue Apr 19 20:17:46 BST 2011, Mike Bostock, Mike Bostock, 51, 31, 82, 0, 256
Fri Apr 15 00:51:53 BST 2011, Mike Bostock, Mike Bostock, 4, 3, 7, 0, 23
Thu Apr 14 23:23:53 BST 2011, Jason Davies, Jason Davies, 11, 11, 22, 0, 37
Thu Apr 14 22:20:07 BST 2011, Mike Bostock, Mike Bostock, 79, 0, 79, 0, 25
Thu Apr 14 09:41:19 BST 2011, Jason Davies, Jason Davies, 71, 71, 142, 0, 47
Thu Apr 14 07:59:15 BST 2011, Mike Bostock, Mike Bostock, 0, 50, 50, 0, 107
Thu Apr 14 07:58:46 BST 2011, Mike Bostock, Mike Bostock, 3, 858, 861, 0, 35
Thu Apr 14 07:54:47 BST 2011, Mike Bostock, Mike Bostock, 2511, 117, 2628, 0, 22
Thu Apr 14 07:53:59 BST 2011, Mike Bostock, Mike Bostock, 975, 60, 1035, 0, 31
Thu Apr 14 07:51:29 BST 2011, Mike Bostock, Mike Bostock, 703, 53, 756, 0, 35
Thu Apr 14 07:49:53 BST 2011, Mike Bostock, Mike Bostock, 758, 1, 759, 0, 32
Thu Apr 14 07:45:54 BST 2011, Mike Bostock, Mike Bostock, 0, 1, 1, 0, 18
Thu Apr 14 07:44:25 BST 2011, Mike Bostock, Mike Bostock, 17, 17, 34, 0, 32
Thu Apr 14 07:28:04 BST 2011, Mike Bostock, Mike Bostock, 7, 7, 14, 0, 262
Thu Apr 14 07:13:06 BST 2011, Mike Bostock, Mike Bostock, 106, 71, 177, 0, 496
Thu Apr 14 06:41:30 BST 2011, Mike Bostock, Mike Bostock, 35, 69, 104, 0, 217
Thu Apr 14 06:04:11 BST 2011, Mike Bostock, Mike Bostock, 157, 207, 364, 0, 499
Thu Apr 14 02:50:26 BST 2011, Mike Bostock, Mike Bostock, 47, 37, 84, 0, 443
Thu Apr 14 02:12:16 BST 2011, Mike Bostock, Mike Bostock, 115, 0, 115, 0, 25
Thu Apr 14 01:31:16 BST 2011, Mike Bostock, Mike Bostock, 249, 121, 370, 4, 1375
Thu Apr 14 01:16:51 BST 2011, Mike Bostock, Mike Bostock, 8, 4, 12, 0, 116
Wed Apr 13 23:40:00 BST 2011, Jason Davies, Jason Davies, 15, 5, 20, 0, 223
Wed Apr 13 23:27:52 BST 2011, Jason Davies, Jason Davies, 3, 3, 6, 0, 20
Wed Apr 13 23:27:25 BST 2011, Jason Davies, Jason Davies, 3, 5, 8, 0, 23
Wed Apr 13 23:20:16 BST 2011, Jason Davies, Jason Davies, 0, 4, 4, 0, 26
Wed Apr 13 23:16:10 BST 2011, Jason Davies, Jason Davies, 4, 5, 9, 0, 21
Wed Apr 13 23:12:18 BST 2011, Jason Davies, Jason Davies, 120, 9, 129, 0, 156
Wed Apr 13 22:33:15 BST 2011, Jason Davies, Jason Davies, 10, 10, 20, 0, 37
Wed Apr 13 22:31:53 BST 2011, Jason Davies, Jason Davies, 49, 49, 98, 0, 26
Wed Apr 13 22:29:44 BST 2011, Jason Davies, Jason Davies, 3, 3, 6, 0, 24
Wed Apr 13 22:27:25 BST 2011, Jason Davies, Jason Davies, 17, 34, 51, 0, 54
Wed Apr 13 22:21:29 BST 2011, Jason Davies, Jason Davies, 41, 13, 54, 0, 148
Wed Apr 13 21:59:37 BST 2011, Jason Davies, Jason Davies, 69, 9, 78, 0, 133
Wed Apr 13 21:09:31 BST 2011, Jason Davies, Jason Davies, 100, 26, 126, 0, 363
Wed Apr 13 20:39:12 BST 2011, Jason Davies, Jason Davies, 11, 21, 32, 0, 112
Wed Apr 13 20:35:33 BST 2011, Jason Davies, Jason Davies, 5, 5, 10, 0, 151
Wed Apr 13 20:34:13 BST 2011, Jason Davies, Jason Davies, 28, 28, 56, 0, 107
Wed Apr 13 20:13:58 BST 2011, Jason Davies, Jason Davies, 29, 5, 34, 0, 31
Wed Apr 13 18:53:52 BST 2011, Jason Davies, Jason Davies, 386, 1, 387, 0, 18
Tue Apr 12 03:11:44 BST 2011, Nelson Minar, Nelson Minar, 1, 1, 2, 0, 17
Tue Apr 12 03:10:27 BST 2011, Nelson Minar, Nelson Minar, 2, 0, 2, 0, 41
Tue Apr 12 03:09:19 BST 2011, Nelson Minar, Nelson Minar, 33, 22, 55, 0, 34
Tue Apr 12 03:02:48 BST 2011, Nelson Minar, Nelson Minar, 943, 26, 969, 0, 78
Mon Apr 11 21:52:21 BST 2011, Mike Bostock, Mike Bostock, 17, 6, 23, 0, 20
Mon Apr 11 21:22:24 BST 2011, Mike Bostock, Mike Bostock, 16, 5, 21, 0, 25
Mon Apr 11 20:55:27 BST 2011, Mike Bostock, Mike Bostock, 10, 10, 20, 0, 23
Mon Apr 11 20:44:17 BST 2011, Mike Bostock, Mike Bostock, 203, 242, 445, 0, 417
Mon Apr 11 11:25:19 BST 2011, Jason Davies, Jason Davies, 1, 0, 1, 0, 37
Mon Apr 11 10:50:34 BST 2011, Jason Davies, Jason Davies, 678, 2, 680, 0, 203
Mon Apr 11 09:54:33 BST 2011, Jason Davies, Jason Davies, 797, 1, 798, 0, 490
Mon Apr 11 07:26:35 BST 2011, Mike Bostock, Mike Bostock, 22, 25, 47, 0, 43
Mon Apr 11 02:56:16 BST 2011, Mike Bostock, Mike Bostock, 5, 3, 8, 0, 34
Mon Apr 11 02:44:45 BST 2011, Mike Bostock, Mike Bostock, 924, 4, 928, 0, 19
Mon Apr 11 02:37:23 BST 2011, Mike Bostock, Mike Bostock, 8, 8, 16, 0, 36
Mon Apr 11 02:28:59 BST 2011, Mike Bostock, Mike Bostock, 37, 35, 72, 0, 32
Mon Apr 11 00:16:13 BST 2011, Nelson Minar, Nelson Minar, 6, 18, 24, 0, 50
Sun Apr 10 22:42:25 BST 2011, Nelson Minar, Nelson Minar, 78, 4, 82, 0, 31
Sun Apr 10 21:56:34 BST 2011, Mike Bostock, Mike Bostock, 77, 23, 100, 0, 31
Sun Apr 10 21:29:32 BST 2011, Mike Bostock, Mike Bostock, 73, 1, 74, 0, 24
Sun Apr 10 21:15:15 BST 2011, Mike Bostock, Mike Bostock, 19, 19, 38, 0, 19
Sun Apr 10 21:04:21 BST 2011, Mike Bostock, Mike Bostock, 107, 111, 218, 0, 35
Sun Apr 10 20:47:32 BST 2011, Mike Bostock, Mike Bostock, 55, 59, 114, 0, 30
Sun Apr 10 20:36:58 BST 2011, Mike Bostock, Mike Bostock, 127, 129, 256, 0, 30
Sun Apr 10 20:16:26 BST 2011, Mike Bostock, Mike Bostock, 45, 45, 90, 0, 36
Sun Apr 10 20:07:17 BST 2011, Mike Bostock, Mike Bostock, 211, 279, 490, 0, 296
Sun Apr 10 18:45:51 BST 2011, Mike Bostock, Mike Bostock, 30, 16, 46, 0, 36
Sun Apr 10 16:25:04 BST 2011, Jason Davies, Jason Davies, 1, 2, 3, 0, 44
Sun Apr 10 10:46:13 BST 2011, Jason Davies, Jason Davies, 856, 1, 857, 0, 168
Sat Apr 09 22:14:10 BST 2011, Mike Bostock, Mike Bostock, 0, 0, 0, 0, 98
Sat Apr 09 22:09:09 BST 2011, Jason Davies, Jason Davies, 0, 2, 2, 0, 40
Sat Apr 09 21:46:25 BST 2011, Mike Bostock, Mike Bostock, 10, 8, 18, 0, 348
Sat Apr 09 21:00:38 BST 2011, Mike Bostock, Mike Bostock, 2, 2, 4, 0, 22
Sat Apr 09 20:38:48 BST 2011, Mike Bostock, Mike Bostock, 68, 205, 273, 0, 33
Sat Apr 09 20:08:14 BST 2011, Mike Bostock, Mike Bostock, 32, 0, 32, 0, 16
Sat Apr 09 20:05:55 BST 2011, Mike Bostock, Mike Bostock, 32, 0, 32, 0, 16
Sat Apr 09 20:03:52 BST 2011, Mike Bostock, Mike Bostock, 1, 0, 1, 0, 37
Sat Apr 09 19:27:30 BST 2011, Mike Bostock, Mike Bostock, 749, 55, 804, 0, 21
Sat Apr 09 19:23:53 BST 2011, Mike Bostock, Mike Bostock, 3, 3, 6, 0, 44
Sat Apr 09 18:55:33 BST 2011, Mike Bostock, Mike Bostock, 2, 4, 6, 0, 45
Sat Apr 09 18:43:09 BST 2011, Mike Bostock, Mike Bostock, 275, 331, 606, 0, 590
Sat Apr 09 18:35:04 BST 2011, Mike Bostock, Mike Bostock, 18, 36, 54, 0, 242
Sat Apr 09 16:41:26 BST 2011, Jason Davies, Jason Davies, 51, 27, 78, 0, 194
Sat Apr 09 00:42:43 BST 2011, Michael Bostock, Michael Bostock, 8, 7, 15, 0, 36
Sat Apr 09 00:37:01 BST 2011, Michael Bostock, Michael Bostock, 0, 0, 0, 0, 70
Sat Apr 09 00:36:16 BST 2011, Michael Bostock, Michael Bostock, 4, 4, 8, 0, 11
Sat Apr 09 00:10:46 BST 2011, Jason Davies, Jason Davies, 79, 24, 103, 0, 58
Sat Apr 09 00:03:01 BST 2011, Michael Bostock, Michael Bostock, 79, 24, 103, 0, 346
Fri Apr 08 23:51:55 BST 2011, Jason Davies, Jason Davies, 20, 17, 37, 0, 72
Fri Apr 08 23:47:59 BST 2011, Jason Davies, Jason Davies, 204, 215, 419, 0, 121
Fri Apr 08 23:46:14 BST 2011, Michael Bostock, Michael Bostock, 20, 17, 37, 0, 571
Fri Apr 08 23:35:26 BST 2011, Michael Bostock, Michael Bostock, 15, 9, 24, 0, 41
Fri Apr 08 23:33:01 BST 2011, Michael Bostock, Michael Bostock, 12, 12, 24, 0, 291
Fri Apr 08 22:40:29 BST 2011, Michael Bostock, Michael Bostock, 178, 190, 368, 0, 277
Fri Apr 08 20:08:33 BST 2011, Jason Davies, Jason Davies, 9, 4, 13, 0, 22
Fri Apr 08 19:17:09 BST 2011, Jason Davies, Jason Davies, 3, 3, 6, 0, 27
Fri Apr 08 19:15:55 BST 2011, Jason Davies, Jason Davies, 9, 9, 18, 0, 45
Fri Apr 08 19:12:18 BST 2011, Jason Davies, Jason Davies, 61, 71, 132, 0, 44
Fri Apr 08 18:37:59 BST 2011, Jason Davies, Jason Davies, 49, 79, 128, 0, 49
Fri Apr 08 18:25:08 BST 2011, Jason Davies, Jason Davies, 7, 10, 17, 0, 48
Fri Apr 08 18:17:35 BST 2011, Jason Davies, Jason Davies, 15, 12, 27, 0, 45
Fri Apr 08 11:29:33 BST 2011, Jason Davies, Jason Davies, 3, 0, 3, 0, 18
Fri Apr 08 11:24:51 BST 2011, Jason Davies, Jason Davies, 125, 29, 154, 0, 42
Fri Apr 08 10:56:41 BST 2011, Jason Davies, Jason Davies, 5, 5, 10, 0, 28
Fri Apr 08 10:53:48 BST 2011, Jason Davies, Jason Davies, 87, 34, 121, 0, 47
Fri Apr 08 08:43:44 BST 2011, Jason Davies, Jason Davies, 373, 306, 679, 0, 84
Fri Apr 08 00:57:33 BST 2011, Michael Bostock, Michael Bostock, 365, 275, 640, 0, 423
Thu Apr 07 23:14:15 BST 2011, Jason Davies, Jason Davies, 41, 23, 64, 0, 46
Thu Apr 07 23:03:55 BST 2011, Michael Bostock, Michael Bostock, 8, 10, 18, 0, 45
Thu Apr 07 22:59:36 BST 2011, Michael Bostock, Michael Bostock, 8, 10, 18, 0, 385
Thu Apr 07 22:38:50 BST 2011, Jason Davies, Jason Davies, 9, 9, 18, 0, 19
Thu Apr 07 22:36:25 BST 2011, Jason Davies, Jason Davies, 18, 4, 22, 0, 41
Thu Apr 07 22:29:04 BST 2011, Jason Davies, Jason Davies, 24, 30, 54, 0, 51
Thu Apr 07 19:39:43 BST 2011, Jason Davies, Jason Davies, 13, 3, 16, 0, 48
Thu Apr 07 19:32:48 BST 2011, Jason Davies, Jason Davies, 64, 36, 100, 0, 36
Thu Apr 07 19:05:15 BST 2011, Jason Davies, Jason Davies, 0, 16, 16, 0, 49
Thu Apr 07 18:54:00 BST 2011, Jason Davies, Jason Davies, 63, 27, 90, 0, 43
Thu Apr 07 18:21:11 BST 2011, Jason Davies, Jason Davies, 97, 68, 165, 0, 59
Thu Apr 07 17:54:03 BST 2011, Jason Davies, Jason Davies, 171, 160, 331, 0, 34
Wed Apr 06 20:49:15 BST 2011, Jason Davies, Jason Davies, 137, 27, 164, 0, 98
Wed Apr 06 20:18:04 BST 2011, Jason Davies, Jason Davies, 17, 9, 26, 0, 28
Wed Apr 06 20:16:12 BST 2011, Jason Davies, Jason Davies, 23, 26, 49, 0, 40
Wed Apr 06 19:47:55 BST 2011, Jason Davies, Jason Davies, 276, 1, 277, 0, 28
Tue Apr 05 18:34:21 BST 2011, Mike Bostock, Mike Bostock, 3218, 619, 3837, 0, 35
Tue Apr 05 18:22:51 BST 2011, Mike Bostock, Mike Bostock, 3214, 621, 3835, 0, 86
Fri Apr 01 20:08:37 BST 2011, Michael Bostock, Michael Bostock, 7, 6, 13, 0, 15
Wed Mar 30 17:18:14 BST 2011, Michael Bostock, Michael Bostock, 85, 57, 142, 0, 32
Wed Mar 30 17:07:08 BST 2011, Michael Bostock, Michael Bostock, 0, 18, 18, 0, 28
Wed Mar 30 17:06:50 BST 2011, Michael Bostock, Michael Bostock, 6, 12, 18, 0, 33
Wed Mar 30 17:04:55 BST 2011, Michael Bostock, Michael Bostock, 6, 12, 18, 0, 82
Wed Mar 30 15:56:04 BST 2011, Nelson Minar, Nelson Minar, 6, 12, 18, 0, 43
Wed Mar 30 10:59:24 BST 2011, Michael Bostock, Michael Bostock, 5, 5, 10, 0, 116
Wed Mar 30 10:32:09 BST 2011, Jason Davies, Jason Davies, 5, 5, 10, 0, 50
Tue Mar 29 22:57:01 BST 2011, Michael Bostock, Michael Bostock, 11, 10, 21, 0, 27
Sat Mar 26 17:50:32 GMT 2011, Michael Bostock, Michael Bostock, 377, 0, 377, 0, 28
Fri Mar 25 13:03:46 GMT 2011, Michael Bostock, Michael Bostock, 2, 0, 2, 0, 31
Fri Mar 25 10:25:43 GMT 2011, Jason Davies, Jason Davies, 5114, 635, 5749, 0, 352
Fri Mar 18 00:52:55 GMT 2011, Michael Bostock, Michael Bostock, 52, 11, 63, 0, 39
Fri Mar 18 00:35:04 GMT 2011, Michael Bostock, Michael Bostock, 48, 8, 56, 0, 94
Thu Mar 17 17:24:02 GMT 2011, Michael Bostock, Michael Bostock, 6, 6, 12, 0, 42
Tue Mar 15 16:22:13 GMT 2011, Michael Bostock, Michael Bostock, 15, 14, 29, 0, 34
Tue Mar 15 13:06:36 GMT 2011, Jason Davies, Jason Davies, 1, 1, 2, 0, 269
Tue Mar 15 06:43:45 GMT 2011, Michael Bostock, Michael Bostock, 458, 135, 593, 0, 30
Tue Mar 15 06:39:11 GMT 2011, Michael Bostock, Michael Bostock, 175, 31, 206, 0, 313
Sun Mar 13 18:38:10 GMT 2011, Michael Bostock, Michael Bostock, 281, 102, 383, 0, 43
Sun Mar 13 05:54:51 GMT 2011, Michael Bostock, Michael Bostock, 365, 366, 731, 0, 29
Sun Mar 13 05:52:00 GMT 2011, Michael Bostock, Michael Bostock, 1271, 358, 1629, 0, 218
Sun Mar 13 05:20:41 GMT 2011, Mike Bostock, Mike Bostock, 1, 4, 5, 0, 31
Sun Mar 13 05:14:07 GMT 2011, Mike Bostock, Mike Bostock, 120, 41, 161, 0, 86
Sun Mar 13 04:24:17 GMT 2011, Mike Bostock, Mike Bostock, 19, 0, 19, 0, 25
Sun Mar 13 04:17:31 GMT 2011, Mike Bostock, Mike Bostock, 108, 1, 109, 0, 28
Sun Mar 13 01:00:55 GMT 2011, Mike Bostock, Mike Bostock, 258, 46, 304, 0, 198
Sat Mar 12 21:25:39 GMT 2011, Jason Davies, Jason Davies, 20, 8, 28, 0, 38
Sat Mar 12 20:43:51 GMT 2011, Mike Bostock, Mike Bostock, 390, 115, 505, 0, 87
Sat Mar 12 20:43:15 GMT 2011, Jason Davies, Jason Davies, 33, 5, 38, 0, 30
Sat Mar 12 18:27:05 GMT 2011, Michael Bostock, Michael Bostock, 422, 198, 620, 0, 102
Sat Mar 12 17:03:06 GMT 2011, Michael Bostock, Michael Bostock, 464, 226, 690, 0, 42
Sat Mar 12 17:00:06 GMT 2011, Michael Bostock, Michael Bostock, 367, 138, 505, 0, 47
Sat Mar 12 16:29:26 GMT 2011, Mike Bostock, Mike Bostock, 367, 138, 505, 0, 30
Sat Mar 12 16:27:58 GMT 2011, Mike Bostock, Mike Bostock, 191, 145, 336, 0, 68
Sat Mar 12 16:25:49 GMT 2011, Mike Bostock, Mike Bostock, 47, 10, 57, 0, 34
Sat Mar 12 16:16:13 GMT 2011, Mike Bostock, Mike Bostock, 18, 5, 23, 0, 80
Sat Mar 12 12:09:30 GMT 2011, Jason Davies, Jason Davies, 15, 0, 15, 0, 37
Sat Mar 12 11:30:08 GMT 2011, Jason Davies, Jason Davies, 42, 53, 95, 0, 35
Sat Mar 12 11:17:16 GMT 2011, Jason Davies, Jason Davies, 3, 5, 8, 0, 47
Sat Mar 12 00:32:37 GMT 2011, Jason Davies, Jason Davies, 2681, 2581, 5262, 0, 54
Fri Mar 11 19:40:24 GMT 2011, Michael Bostock, Michael Bostock, 92, 85, 177, 0, 47
Fri Mar 11 19:39:11 GMT 2011, Michael Bostock, Michael Bostock, 5, 3, 8, 0, 38
Fri Mar 11 01:33:53 GMT 2011, Mike Bostock, Mike Bostock, 270, 80, 350, 0, 36
Thu Mar 10 19:55:26 GMT 2011, Mike Bostock, Mike Bostock, 92, 85, 177, 0, 44
Wed Mar 09 17:28:21 GMT 2011, Michael Bostock, Michael Bostock, 1, 1, 2, 0, 34
Wed Mar 09 07:29:59 GMT 2011, Michael Bostock, Michael Bostock, 86, 88, 174, 0, 159
Tue Mar 08 22:52:42 GMT 2011, Michael Bostock, Michael Bostock, 3, 3, 6, 0, 33
Tue Mar 08 22:24:23 GMT 2011, Michael Bostock, Michael Bostock, 90, 1, 91, 0, 36
Tue Mar 08 22:23:31 GMT 2011, Michael Bostock, Michael Bostock, 68, 50, 118, 0, 28
Sat Mar 05 00:35:16 GMT 2011, Michael Bostock, Michael Bostock, 2321, 2396, 4717, 0, 194
Sat Mar 05 00:05:53 GMT 2011, Michael Bostock, Michael Bostock, 90, 27, 117, 0, 201
Fri Mar 04 23:55:42 GMT 2011, Jason Davies, Jason Davies, 38195, 427, 38622, 0, 54
Fri Mar 04 23:25:09 GMT 2011, Michael Bostock, Michael Bostock, 324, 75, 399, 0, 31
Fri Mar 04 21:42:49 GMT 2011, Michael Bostock, Michael Bostock, 189, 148, 337, 0, 766
Fri Mar 04 19:48:14 GMT 2011, Michael Bostock, Michael Bostock, 1, 3, 4, 0, 99
Fri Mar 04 19:47:19 GMT 2011, Michael Bostock, Michael Bostock, 37090, 0, 37090, 0, 15
Fri Mar 04 00:01:18 GMT 2011, Michael Bostock, Michael Bostock, 1, 1, 2, 0, 20
Thu Mar 03 23:43:57 GMT 2011, Michael Bostock, Michael Bostock, 452, 75, 527, 0, 33
Thu Mar 03 22:20:18 GMT 2011, Michael Bostock, Michael Bostock, 309, 296, 605, 0, 38
Wed Mar 02 21:10:32 GMT 2011, Jason Davies, Jason Davies, 232, 11, 243, 0, 34
Tue Mar 01 20:01:09 GMT 2011, Mike Bostock, Mike Bostock, 118, 79, 197, 0, 316
Tue Mar 01 01:02:58 GMT 2011, Michael Bostock, Michael Bostock, 41, 31, 72, 0, 37
Mon Feb 28 23:05:37 GMT 2011, Michael Bostock, Michael Bostock, 155, 161, 316, 0, 47
Mon Feb 28 23:04:20 GMT 2011, Michael Bostock, Michael Bostock, 510, 0, 510, 0, 217
Mon Feb 28 18:12:25 GMT 2011, Mike Bostock, Mike Bostock, 74, 76, 150, 0, 30
Mon Feb 28 02:34:47 GMT 2011, Mike Bostock, Mike Bostock, 1, 6, 7, 0, 37
Mon Feb 28 02:22:23 GMT 2011, Mike Bostock, Mike Bostock, 80, 79, 159, 0, 289
Sun Feb 27 23:05:18 GMT 2011, Michael Bostock, Michael Bostock, 76, 46, 122, 0, 451
Sun Feb 27 21:05:55 GMT 2011, Michael Bostock, Michael Bostock, 53, 59, 112, 0, 28
Sun Feb 27 20:41:31 GMT 2011, Michael Bostock, Michael Bostock, 259, 255, 514, 0, 38
Sun Feb 27 20:36:11 GMT 2011, Michael Bostock, Michael Bostock, 4, 4, 8, 0, 40
Sun Feb 27 20:33:02 GMT 2011, Michael Bostock, Michael Bostock, 1, 1, 2, 0, 21
Sun Feb 27 20:21:11 GMT 2011, Michael Bostock, Michael Bostock, 160, 162, 322, 0, 26
Sun Feb 27 20:09:27 GMT 2011, Michael Bostock, Michael Bostock, 219, 227, 446, 0, 26
Sun Feb 27 19:56:25 GMT 2011, Michael Bostock, Michael Bostock, 7, 9, 16, 0, 22
Sat Feb 26 04:32:09 GMT 2011, Michael Bostock, Michael Bostock, 63, 62, 125, 0, 31
Fri Feb 25 18:01:34 GMT 2011, Michael Bostock, Michael Bostock, 7, 8, 15, 0, 13
Thu Feb 24 22:36:57 GMT 2011, Michael Bostock, Michael Bostock, 39, 21, 60, 1, 327
Thu Feb 24 22:13:05 GMT 2011, Michael Bostock, Michael Bostock, 366, 236, 602, 0, 642
Wed Feb 23 21:04:18 GMT 2011, Michael Bostock, Michael Bostock, 2, 1, 3, 0, 29
Wed Feb 23 20:35:41 GMT 2011, Michael Bostock, Michael Bostock, 5, 5, 10, 0, 77
Wed Feb 23 20:33:18 GMT 2011, Michael Bostock, Michael Bostock, 333, 33, 366, 0, 131
Wed Feb 23 17:09:43 GMT 2011, Mike Bostock, Mike Bostock, 8, 8, 16, 0, 37
Sat Feb 19 20:41:21 GMT 2011, Michael Bostock, Michael Bostock, 99, 71, 170, 0, 122
Fri Feb 18 23:10:17 GMT 2011, Michael Bostock, Michael Bostock, 77, 77, 154, 0, 24
Fri Feb 18 19:50:26 GMT 2011, Jason Davies, Jason Davies, 15, 31, 46, 0, 62
Fri Feb 18 18:40:35 GMT 2011, Jason Davies, Jason Davies, 31, 0, 31, 0, 101
Thu Feb 17 19:56:13 GMT 2011, Michael Bostock, Michael Bostock, 8590, 124, 8714, 0, 692
Wed Feb 16 17:53:48 GMT 2011, Michael Bostock, Michael Bostock, 83, 67, 150, 0, 103
Wed Feb 16 13:26:54 GMT 2011, Jason Davies, Jason Davies, 62, 55, 117, 0, 29
Mon Feb 14 07:20:10 GMT 2011, Michael Bostock, Michael Bostock, 364, 120, 484, 0, 198
Sat Feb 12 03:42:52 GMT 2011, Mike Bostock, Mike Bostock, 255, 78, 333, 0, 241
Sat Feb 12 01:35:21 GMT 2011, Mike Bostock, Mike Bostock, 55, 0, 55, 0, 204
Fri Feb 11 21:44:56 GMT 2011, Michael Bostock, Michael Bostock, 97, 0, 97, 0, 30
Fri Feb 11 21:00:41 GMT 2011, Michael Bostock, Michael Bostock, 495, 92, 587, 0, 711
Tue Feb 08 23:59:03 GMT 2011, Michael Bostock, Michael Bostock, 129, 93, 222, 0, 477
Mon Feb 07 17:56:05 GMT 2011, Michael Bostock, Michael Bostock, 83, 16, 99, 0, 32
Wed Feb 02 20:59:10 GMT 2011, Michael Bostock, Michael Bostock, 7, 9, 16, 0, 39
Wed Feb 02 20:10:39 GMT 2011, Michael Bostock, Michael Bostock, 6, 6, 12, 0, 132
Tue Feb 01 05:32:38 GMT 2011, Michael Bostock, Michael Bostock, 111, 116, 227, 0, 26
Mon Jan 31 19:00:35 GMT 2011, Michael Bostock, Michael Bostock, 291, 252, 543, 0, 1005
Mon Jan 31 05:48:15 GMT 2011, Michael Bostock, Michael Bostock, 192, 277, 469, 0, 29
Sat Jan 29 00:26:09 GMT 2011, Michael Bostock, Michael Bostock, 48, 44, 92, 0, 174
Fri Jan 28 20:09:20 GMT 2011, Michael Bostock, Michael Bostock, 159, 118, 277, 0, 562
Thu Jan 27 23:13:56 GMT 2011, Jason Davies, Jason Davies, 1, 1, 2, 0, 42
Thu Jan 27 22:58:29 GMT 2011, Jason Davies, Jason Davies, 1, 1, 2, 0, 46
Tue Jan 25 19:31:54 GMT 2011, Michael Bostock, Michael Bostock, 123, 65, 188, 0, 160
Fri Jan 21 19:59:14 GMT 2011, Michael Bostock, Michael Bostock, 338, 16, 354, 0, 20
Mon Jan 17 22:55:50 GMT 2011, Michael Bostock, Michael Bostock, 338, 16, 354, 0, 21
Thu Jan 20 18:40:14 GMT 2011, Michael Bostock, Michael Bostock, 245, 245, 490, 0, 25
Thu Jan 20 18:25:03 GMT 2011, Michael Bostock, Michael Bostock, 249, 2, 251, 0, 27
Mon Jan 17 22:16:53 GMT 2011, Michael Bostock, Michael Bostock, 1, 1, 2, 0, 20
Mon Jan 17 20:34:02 GMT 2011, Michael Bostock, Michael Bostock, 1, 144, 145, 0, 13
Mon Jan 17 20:32:19 GMT 2011, Michael Bostock, Michael Bostock, 0, 113, 113, 0, 13
Mon Jan 17 20:27:29 GMT 2011, Michael Bostock, Michael Bostock, 435, 200, 635, 0, 36
Wed Jan 12 00:45:29 GMT 2011, Jason Davies, Jason Davies, 2, 0, 2, 0, 22
Tue Jan 11 22:25:25 GMT 2011, Michael Bostock, Michael Bostock, 65, 29, 94, 0, 38
Tue Jan 11 00:02:43 GMT 2011, Michael Bostock, Michael Bostock, 978, 121, 1099, 0, 434
Mon Jan 10 01:33:35 GMT 2011, Michael Bostock, Michael Bostock, 11, 11, 22, 0, 269
Sat Jan 08 23:18:38 GMT 2011, Michael Bostock, Michael Bostock, 261, 72, 333, 0, 43
Wed Jan 05 23:38:38 GMT 2011, Michael Bostock, Michael Bostock, 13, 11, 24, 0, 90
Wed Jan 05 23:38:17 GMT 2011, Michael Bostock, Michael Bostock, 3216, 1, 3217, 0, 42
Wed Jan 05 19:35:39 GMT 2011, Michael Bostock, Michael Bostock, 739, 913, 1652, 1, 265
Tue Jan 04 23:01:09 GMT 2011, Michael Bostock, Michael Bostock, 15, 6, 21, 0, 115
Tue Jan 04 22:14:53 GMT 2011, Michael Bostock, Michael Bostock, 160, 23, 183, 0, 185
Mon Jan 03 18:30:36 GMT 2011, Michael Bostock, Michael Bostock, 140, 68, 208, 0, 19
Fri Dec 17 20:50:53 GMT 2010, Michael Bostock, Michael Bostock, 96, 64, 160, 0, 107
Thu Dec 16 06:06:24 GMT 2010, Jeffrey Heer, Jeffrey Heer, 262, 244, 506, 0, 36
Wed Dec 15 17:32:29 GMT 2010, Jeffrey Heer, Jeffrey Heer, 553, 65, 618, 0, 48
Wed Dec 15 16:46:23 GMT 2010, Jeffrey Heer, Jeffrey Heer, 170, 79, 249, 0, 53
Tue Dec 14 22:41:41 GMT 2010, Michael Bostock, Michael Bostock, 2, 2, 4, 0, 22
Tue Dec 14 22:41:04 GMT 2010, Michael Bostock, Michael Bostock, 79, 53, 132, 0, 82
Sat Dec 11 00:14:42 GMT 2010, Michael Bostock, Michael Bostock, 13, 9, 22, 0, 103
Thu Dec 09 23:04:24 GMT 2010, Mike Bostock, Mike Bostock, 112, 53, 165, 0, 813
Thu Dec 09 22:46:45 GMT 2010, Mike Bostock, Mike Bostock, 2, 0, 2, 0, 42
Tue Dec 07 04:48:11 GMT 2010, Jeffrey Heer, Jeffrey Heer, 85, 49, 134, 0, 31
Tue Dec 07 04:27:25 GMT 2010, Jeffrey Heer, Jeffrey Heer, 241, 14, 255, 0, 33
Mon Dec 06 23:36:22 GMT 2010, Michael Bostock, Michael Bostock, 3, 3, 6, 0, 25
Mon Dec 06 20:52:37 GMT 2010, Jeffrey Heer, Jeffrey Heer, 31, 41, 72, 0, 31
Tue Nov 30 21:40:05 GMT 2010, Michael Bostock, Michael Bostock, 144, 66, 210, 0, 48
Mon Nov 29 00:28:48 GMT 2010, Michael Bostock, Michael Bostock, 94, 60, 154, 0, 116
Sun Nov 28 21:15:07 GMT 2010, Mike Bostock, Mike Bostock, 344, 74, 418, 0, 43
Sun Nov 28 19:39:35 GMT 2010, Mike Bostock, Mike Bostock, 107, 116, 223, 0, 30
Sun Nov 28 04:35:57 GMT 2010, Mike Bostock, Mike Bostock, 15, 2, 17, 0, 35
Sun Nov 28 02:19:30 GMT 2010, Mike Bostock, Mike Bostock, 199, 71, 270, 0, 40
Sat Nov 27 22:13:02 GMT 2010, Mike Bostock, Mike Bostock, 225, 235, 460, 0, 279
Sat Nov 27 22:10:07 GMT 2010, Mike Bostock, Mike Bostock, 3, 0, 3, 0, 22
Sat Nov 27 18:35:11 GMT 2010, Michael Bostock, Michael Bostock, 106, 58, 164, 0, 344
Sat Nov 27 09:07:00 GMT 2010, Mike Bostock, Mike Bostock, 343, 59, 402, 0, 20
Sat Nov 27 02:01:21 GMT 2010, Michael Bostock, Michael Bostock, 6, 17, 23, 0, 40
Sat Nov 27 01:55:45 GMT 2010, Michael Bostock, Michael Bostock, 399, 125, 524, 0, 350
Fri Nov 26 23:12:36 GMT 2010, Michael Bostock, Michael Bostock, 53, 0, 53, 0, 26
Tue Nov 23 07:58:27 GMT 2010, Michael Bostock, Michael Bostock, 74, 89, 163, 0, 21
Tue Nov 23 00:21:46 GMT 2010, Jeffrey Heer, Jeffrey Heer, 311, 11, 322, 0, 33
Fri Nov 19 01:33:56 GMT 2010, Michael Bostock, Michael Bostock, 11, 8, 19, 0, 34
Tue Nov 16 08:05:22 GMT 2010, Michael Bostock, Michael Bostock, 356, 177, 533, 0, 55
Fri Nov 12 02:32:13 GMT 2010, Michael Bostock, Michael Bostock, 18, 9, 27, 0, 21
Thu Nov 11 06:43:02 GMT 2010, Michael Bostock, Michael Bostock, 1, 1, 2, 0, 30
Wed Nov 10 23:46:58 GMT 2010, Michael Bostock, Michael Bostock, 69, 45, 114, 0, 388
Wed Nov 10 01:54:52 GMT 2010, Michael Bostock, Michael Bostock, 56, 43, 99, 0, 102
Wed Nov 10 00:14:49 GMT 2010, Michael Bostock, Michael Bostock, 89, 31, 120, 0, 42
Tue Nov 09 22:45:02 GMT 2010, Michael Bostock, Michael Bostock, 202, 10, 212, 0, 24
Tue Nov 09 22:42:31 GMT 2010, Michael Bostock, Michael Bostock, 12, 12, 24, 0, 23
Tue Nov 09 22:41:14 GMT 2010, Michael Bostock, Michael Bostock, 1, 0, 1, 0, 49
Tue Nov 09 06:49:31 GMT 2010, Michael Bostock, Michael Bostock, 104, 82, 186, 0, 30
Tue Nov 09 05:55:31 GMT 2010, Michael Bostock, Michael Bostock, 98, 122, 220, 0, 137
Mon Nov 08 22:51:07 GMT 2010, Michael Bostock, Michael Bostock, 3, 9, 12, 0, 13
Mon Nov 08 22:34:14 GMT 2010, Michael Bostock, Michael Bostock, 20, 9, 29, 0, 14
Mon Nov 08 05:09:59 GMT 2010, Michael Bostock, Michael Bostock, 492, 62, 554, 0, 46
Mon Nov 08 04:57:25 GMT 2010, Michael Bostock, Michael Bostock, 109, 186, 295, 0, 31
Mon Nov 08 00:56:02 GMT 2010, Michael Bostock, Michael Bostock, 26, 26, 52, 0, 20
Sun Nov 07 23:59:40 GMT 2010, Michael Bostock, Michael Bostock, 62, 54, 116, 0, 49
Sun Nov 07 21:53:47 GMT 2010, Michael Bostock, Michael Bostock, 3, 3, 6, 0, 41
Sun Nov 07 21:49:59 GMT 2010, Michael Bostock, Michael Bostock, 158, 2, 160, 0, 92
Sun Nov 07 16:53:34 GMT 2010, Michael Bostock, Michael Bostock, 86, 52, 138, 0, 238
Sun Nov 07 07:12:45 GMT 2010, Michael Bostock, Michael Bostock, 70, 54, 124, 0, 372
Sun Nov 07 02:10:50 GMT 2010, Michael Bostock, Michael Bostock, 59, 107, 166, 1, 54
Sun Nov 07 00:24:24 GMT 2010, Michael Bostock, Michael Bostock, 9, 38, 47, 0, 40
Sun Nov 07 00:23:49 GMT 2010, Michael Bostock, Michael Bostock, 533, 0, 533, 0, 32
Sat Nov 06 21:41:04 GMT 2010, Michael Bostock, Michael Bostock, 192, 0, 192, 0, 35
Fri Nov 05 23:23:53 GMT 2010, Michael Bostock, Michael Bostock, 563, 29, 592, 0, 36
Fri Nov 05 18:05:53 GMT 2010, Mike Bostock, Mike Bostock, 111, 0, 111, 0, 26
Fri Nov 05 07:36:34 GMT 2010, Michael Bostock, Michael Bostock, 17, 27, 44, 0, 28
Fri Nov 05 07:29:42 GMT 2010, Michael Bostock, Michael Bostock, 66, 62, 128, 0, 47
Fri Nov 05 07:25:24 GMT 2010, Michael Bostock, Michael Bostock, 339, 334, 673, 0, 39
Fri Nov 05 07:19:38 GMT 2010, Michael Bostock, Michael Bostock, 11, 9, 20, 0, 21
Fri Nov 05 07:11:34 GMT 2010, Michael Bostock, Michael Bostock, 205, 72, 277, 0, 41
Fri Nov 05 06:10:23 GMT 2010, Michael Bostock, Michael Bostock, 5442, 0, 5442, 0, 27
Fri Nov 05 05:33:43 GMT 2010, Michael Bostock, Michael Bostock, 126, 165, 291, 0, 39
Fri Nov 05 05:27:21 GMT 2010, Michael Bostock, Michael Bostock, 265, 64, 329, 0, 101
Fri Nov 05 03:04:13 GMT 2010, Michael Bostock, Michael Bostock, 6, 1, 7, 0, 30
Fri Nov 05 02:54:24 GMT 2010, Michael Bostock, Michael Bostock, 144, 0, 144, 0, 27
Fri Nov 05 02:11:07 GMT 2010, Michael Bostock, Michael Bostock, 0, 67, 67, 0, 13
Fri Nov 05 02:09:21 GMT 2010, Michael Bostock, Michael Bostock, 44, 380, 424, 0, 46
Fri Nov 05 02:02:08 GMT 2010, Michael Bostock, Michael Bostock, 64, 0, 64, 0, 257
Fri Nov 05 00:56:04 GMT 2010, Michael Bostock, Michael Bostock, 32, 3242, 3274, 0, 36
Fri Nov 05 00:15:51 GMT 2010, Michael Bostock, Michael Bostock, 4, 4, 8, 0, 29
Fri Nov 05 00:13:47 GMT 2010, Michael Bostock, Michael Bostock, 68, 0, 68, 0, 26
Thu Nov 04 17:43:47 GMT 2010, Michael Bostock, Michael Bostock, 14, 10, 24, 0, 34
Wed Nov 03 18:19:20 GMT 2010, Mike Bostock, Mike Bostock, 851, 63, 914, 0, 43
Wed Nov 03 06:25:09 GMT 2010, Mike Bostock, Mike Bostock, 12, 49, 61, 0, 81
Wed Nov 03 06:06:32 GMT 2010, Mike Bostock, Mike Bostock, 270, 141, 411, 0, 44
Wed Nov 03 00:07:51 GMT 2010, Michael Bostock, Michael Bostock, 2, 2, 4, 0, 45
Tue Nov 02 23:54:18 GMT 2010, Michael Bostock, Michael Bostock, 150, 78, 228, 0, 113
Tue Nov 02 22:27:45 GMT 2010, Michael Bostock, Michael Bostock, 3836, 48, 3884, 0, 46
Tue Nov 02 21:48:51 GMT 2010, Michael Bostock, Michael Bostock, 28, 0, 28, 0, 21
Tue Nov 02 21:48:28 GMT 2010, Michael Bostock, Michael Bostock, 27, 0, 27, 0, 21
Tue Nov 02 06:28:27 GMT 2010, Michael Bostock, Michael Bostock, 171, 33, 204, 0, 18
Sat Oct 30 23:30:10 BST 2010, Michael Bostock, Michael Bostock, 966, 792, 1758, 0, 100
Sat Oct 30 07:24:53 BST 2010, Michael Bostock, Michael Bostock, 93, 45, 138, 0, 10
Fri Oct 29 17:58:33 BST 2010, Michael Bostock, Michael Bostock, 33, 29, 62, 0, 33
Wed Oct 27 06:48:37 BST 2010, Michael Bostock, Michael Bostock, 61, 49, 110, 0, 41
Tue Oct 26 23:32:41 BST 2010, Michael Bostock, Michael Bostock, 123, 43, 166, 0, 429
Tue Oct 26 00:03:37 BST 2010, Michael Bostock, Michael Bostock, 48, 40, 88, 0, 48
Mon Oct 25 08:12:44 BST 2010, Michael Bostock, Michael Bostock, 92, 36, 128, 0, 40
Mon Oct 25 01:24:06 BST 2010, Michael Bostock, Michael Bostock, 9, 10, 19, 0, 29
Mon Oct 25 01:09:32 BST 2010, Michael Bostock, Michael Bostock, 29, 28, 57, 0, 33
Mon Oct 25 01:05:59 BST 2010, Michael Bostock, Michael Bostock, 316, 112, 428, 0, 35
Mon Oct 25 00:15:43 BST 2010, Michael Bostock, Michael Bostock, 91, 65, 156, 0, 30
Mon Oct 25 00:03:35 BST 2010, Michael Bostock, Michael Bostock, 76, 64, 140, 0, 36
Sun Oct 24 23:27:04 BST 2010, Michael Bostock, Michael Bostock, 167, 64, 231, 0, 36
Sun Oct 24 22:03:12 BST 2010, Michael Bostock, Michael Bostock, 71, 41, 112, 0, 43
Sun Oct 24 20:37:59 BST 2010, Michael Bostock, Michael Bostock, 155, 154, 309, 0, 34
Sun Oct 24 20:13:15 BST 2010, Michael Bostock, Michael Bostock, 129, 161, 290, 0, 201
Sun Oct 24 19:43:32 BST 2010, Michael Bostock, Michael Bostock, 128, 97, 225, 0, 33
Sun Oct 24 19:10:51 BST 2010, Michael Bostock, Michael Bostock, 111, 29, 140, 0, 42
Sun Oct 24 18:56:29 BST 2010, Michael Bostock, Michael Bostock, 155, 117, 272, 0, 44
Sun Oct 24 18:39:34 BST 2010, Michael Bostock, Michael Bostock, 151, 155, 306, 0, 27
Sun Oct 24 17:48:43 BST 2010, Michael Bostock, Michael Bostock, 9, 9, 18, 0, 28
Sun Oct 24 04:48:51 BST 2010, Michael Bostock, Michael Bostock, 15, 17, 32, 0, 26
Sun Oct 24 04:46:17 BST 2010, Michael Bostock, Michael Bostock, 98, 114, 212, 0, 39
Sun Oct 24 04:32:16 BST 2010, Michael Bostock, Michael Bostock, 1100, 2424, 3524, 0, 41
Sun Oct 24 02:39:26 BST 2010, Michael Bostock, Michael Bostock, 96, 13, 109, 0, 270
Sun Oct 24 01:45:41 BST 2010, Michael Bostock, Michael Bostock, 113, 32, 145, 0, 195
Sun Oct 24 01:00:04 BST 2010, Michael Bostock, Michael Bostock, 106, 125, 231, 0, 477
Sun Oct 24 00:08:54 BST 2010, Michael Bostock, Michael Bostock, 40, 53, 93, 0, 40
Sat Oct 23 23:34:30 BST 2010, Michael Bostock, Michael Bostock, 38, 65, 103, 0, 137
Sat Oct 23 23:14:47 BST 2010, Michael Bostock, Michael Bostock, 122, 52, 174, 0, 91
Sat Oct 23 21:06:12 BST 2010, Michael Bostock, Michael Bostock, 39, 26, 65, 0, 36
Sat Oct 23 20:32:46 BST 2010, Michael Bostock, Michael Bostock, 14, 3, 17, 0, 38
Sat Oct 23 20:28:14 BST 2010, Michael Bostock, Michael Bostock, 45, 40, 85, 0, 361
Sat Oct 23 19:52:26 BST 2010, Michael Bostock, Michael Bostock, 18, 8, 26, 0, 30
Sat Oct 23 19:47:18 BST 2010, Michael Bostock, Michael Bostock, 169, 78, 247, 0, 41
Sat Oct 23 18:29:32 BST 2010, Michael Bostock, Michael Bostock, 20, 24, 44, 0, 277
Sat Oct 23 18:19:37 BST 2010, Michael Bostock, Michael Bostock, 109, 12, 121, 0, 32
Sat Oct 23 16:22:03 BST 2010, Michael Bostock, Michael Bostock, 18, 5, 23, 0, 136
Sat Oct 23 06:52:54 BST 2010, Michael Bostock, Michael Bostock, 57, 49, 106, 0, 33
Sat Oct 23 06:32:14 BST 2010, Michael Bostock, Michael Bostock, 130, 62, 192, 0, 34
Sat Oct 23 04:02:34 BST 2010, Michael Bostock, Michael Bostock, 179, 0, 179, 0, 40
Sat Oct 23 00:06:59 BST 2010, Michael Bostock, Michael Bostock, 26, 32, 58, 0, 36
Fri Oct 22 21:36:48 BST 2010, Michael Bostock, Michael Bostock, 74, 46, 120, 0, 186
Fri Oct 22 20:55:50 BST 2010, Michael Bostock, Michael Bostock, 58, 16, 74, 0, 37
Fri Oct 22 20:16:43 BST 2010, Michael Bostock, Michael Bostock, 34, 36, 70, 0, 311
Thu Oct 21 21:09:39 BST 2010, Michael Bostock, Michael Bostock, 26, 23, 49, 0, 277
Thu Oct 21 20:53:56 BST 2010, Michael Bostock, Michael Bostock, 129, 35, 164, 0, 18
Wed Oct 20 23:42:15 BST 2010, Michael Bostock, Michael Bostock, 19, 23, 42, 0, 34
Wed Oct 20 23:22:22 BST 2010, Michael Bostock, Michael Bostock, 203, 62, 265, 0, 25
Wed Oct 20 19:07:42 BST 2010, Michael Bostock, Michael Bostock, 271, 39, 310, 0, 363
Thu Oct 14 18:29:17 BST 2010, Michael Bostock, Michael Bostock, 24, 22, 46, 0, 41
Thu Oct 14 18:25:56 BST 2010, Michael Bostock, Michael Bostock, 13, 12, 25, 0, 27
Thu Oct 14 18:25:12 BST 2010, Michael Bostock, Michael Bostock, 0, 0, 0, 0, 31
Thu Oct 14 18:23:15 BST 2010, Michael Bostock, Michael Bostock, 64, 36, 100, 0, 35
Thu Oct 14 18:21:07 BST 2010, Michael Bostock, Michael Bostock, 37, 63, 100, 0, 114
Sun Oct 10 18:37:07 BST 2010, Michael Bostock, Michael Bostock, 15, 16, 31, 0, 20
Wed Oct 06 23:20:38 BST 2010, Michael Bostock, Michael Bostock, 23, 14, 37, 0, 27
Tue Oct 05 19:57:27 BST 2010, Michael Bostock, Michael Bostock, 72, 45, 117, 0, 80
Tue Oct 05 19:37:14 BST 2010, Michael Bostock, Michael Bostock, 5392, 2, 5394, 0, 25
Tue Oct 05 04:57:56 BST 2010, Michael Bostock, Michael Bostock, 43, 16, 59, 0, 21
Tue Oct 05 04:41:18 BST 2010, Michael Bostock, Michael Bostock, 1396, 0, 1396, 0, 20
Tue Oct 05 04:31:12 BST 2010, Michael Bostock, Michael Bostock, 1, 0, 1, 0, 24
Tue Oct 05 01:28:01 BST 2010, Mike Bostock, Mike Bostock, 5401, 6, 5407, 0, 40
Mon Oct 04 21:01:56 BST 2010, Mike Bostock, Mike Bostock, 131, 0, 131, 0, 28
Sat Oct 02 19:38:50 BST 2010, Mike Bostock, Mike Bostock, 13, 13, 26, 0, 31
Sat Oct 02 19:00:31 BST 2010, Mike Bostock, Mike Bostock, 89, 89, 178, 0, 21
Wed Sep 29 20:58:50 BST 2010, Mike Bostock, Mike Bostock, 5, 3, 8, 0, 21
Wed Sep 29 07:18:51 BST 2010, Mike Bostock, Mike Bostock, 320, 373, 693, 0, 19
Wed Sep 29 02:34:45 BST 2010, Mike Bostock, Mike Bostock, 1, 1, 2, 0, 49
Wed Sep 29 02:04:58 BST 2010, Mike Bostock, Mike Bostock, 64, 21, 85, 0, 43
Wed Sep 29 01:38:31 BST 2010, Mike Bostock, Mike Bostock, 1, 1, 2, 0, 14
Wed Sep 29 01:37:59 BST 2010, Mike Bostock, Mike Bostock, 0, 2, 2, 0, 14
Wed Sep 29 01:36:53 BST 2010, Mike Bostock, Mike Bostock, 13, 1, 14, 0, 14
Tue Sep 28 21:00:28 BST 2010, Mike Bostock, Mike Bostock, 2, 1, 3, 0, 36
Tue Sep 28 20:55:33 BST 2010, Mike Bostock, Mike Bostock, 157, 18, 175, 0, 37
Tue Sep 28 19:34:52 BST 2010, Mike Bostock, Mike Bostock, 2106, 0, 2106, 0, 20
Tue Sep 28 19:29:21 BST 2010, Mike Bostock, Mike Bostock, 27, 0, 27, 0, 16
Tue Sep 28 19:26:55 BST 2010, Mike Bostock, Mike Bostock, 2932, 0, 2932, 0, 18
Tue Sep 28 19:25:21 BST 2010, Mike Bostock, Mike Bostock, 463, 0, 463, 0, 28
Mon Sep 27 18:23:59 BST 2010, Mike Bostock, Mike Bostock, 1, 0, 1, 0, 11
Mon Sep 27 18:20:44 BST 2010, Mike Bostock, Mike Bostock, 0, 0, 0, 2, 15
