date,author,committer,additions,deletions,total,comments,messageLength
2019-11-20 15:34:14.000,"Mike Bostock","Mike Bostock",11,3,14,0,24
2019-11-20 15:32:23.000,"Mike Bostock","Mike Bostock",1,1,2,0,6
2019-11-20 15:32:18.000,"Mike Bostock","Mike Bostock",17,17,34,0,16
2019-11-19 00:28:27.000,"Mike Bostock","Mike Bostock",34,34,68,0,21
2019-11-17 22:50:51.000,"Mike Bostock","Mike Bostock",1,1,2,0,6
2019-11-17 22:50:47.000,"Mike Bostock","Mike Bostock",34,34,68,0,21
2019-11-17 16:16:23.000,"Mike Bostock","Mike Bostock",1,1,2,0,6
2019-11-17 16:16:17.000,"Mike Bostock","Mike Bostock",182,181,363,0,20
2019-11-16 20:59:39.000,"Mike Bostock","Mike Bostock",1,1,2,0,6
2019-11-16 20:59:33.000,"Mike Bostock","Mike Bostock",17,17,34,0,16
2019-11-16 19:53:24.000,"Mike Bostock","Mike Bostock",1,1,2,0,6
2019-11-16 19:52:39.000,"Mike Bostock","Mike Bostock",729,718,1447,0,20
2019-09-25 06:15:09.000,"Mike Bostock","Mike Bostock",2,2,4,0,17
2019-09-24 23:43:58.000,"Tom MacWright","Mike Bostock",3,3,6,0,29
2019-09-07 04:55:15.000,"Mike Bostock","Mike Bostock",1,1,2,0,6
2019-09-07 04:55:08.000,"Mike Bostock","Mike Bostock",14,14,28,0,17
2019-08-21 07:39:36.000,"Mike Bostock","Mike Bostock",1,1,2,0,6
2019-08-21 07:39:26.000,"Mike Bostock","Mike Bostock",80,78,158,0,26
2019-08-21 05:00:59.000,"Mike Bostock","Mike Bostock",1,1,2,0,6
2019-08-21 05:00:47.000,"Mike Bostock","Mike Bostock",3,3,6,0,17
2019-08-19 20:22:50.000,"Mike Bostock","Mike Bostock",1,1,2,0,11
2019-08-19 20:20:52.000,"Mike Bostock","Mike Bostock",2,0,2,0,15
2019-08-19 20:19:06.000,"Mike Bostock","Mike Bostock",422,415,837,0,11
2019-08-19 17:47:33.000,"Mike Bostock","Mike Bostock",1,1,2,0,6
2019-08-19 17:42:48.000,"Mike Bostock","Mike Bostock",273,92,365,0,20
2019-08-15 14:59:35.000,"Mike Bostock","Mike Bostock",8,8,16,0,22
2019-08-01 15:58:12.000,"Mike Bostock","GitHub",4,4,8,0,24
2019-08-01 15:57:55.000,"Mike Bostock","GitHub",8,5,13,0,24
2019-08-01 15:48:52.000,"Mike Bostock","GitHub",1,1,2,0,24
2019-06-28 05:35:12.000,"Mike Bostock","Mike Bostock",1,1,2,0,5
2019-06-28 05:35:12.000,"Mike Bostock","Mike Bostock",3,3,6,0,16
2019-06-28 03:48:56.000,"Mike Bostock","Mike Bostock",1,1,2,0,5
2019-06-28 03:48:49.000,"Mike Bostock","Mike Bostock",3,3,6,0,16
2019-06-27 21:14:33.000,"Mike Bostock","Mike Bostock",1,1,2,0,5
2019-06-27 21:14:33.000,"Mike Bostock","Mike Bostock",3,3,6,0,16
2019-06-26 19:19:13.000,"Mike Bostock","Mike Bostock",1,1,2,0,5
2019-06-26 19:19:13.000,"Mike Bostock","Mike Bostock",3,3,6,0,20
2019-06-26 19:06:33.000,"Mike Bostock","Mike Bostock",1,1,2,0,5
2019-06-26 19:06:31.000,"Mike Bostock","Mike Bostock",10,6,16,0,20
2019-05-02 15:23:05.000,"Mike Bostock","GitHub",1118,1118,2236,0,18
2019-03-14 16:13:15.000,"Mike Bostock","Mike Bostock",1,1,2,0,5
2019-03-14 16:13:06.000,"Mike Bostock","Mike Bostock",71,74,145,0,16
2019-02-10 04:34:31.000,"Mike Bostock","Mike Bostock",1,1,2,0,5
2019-02-10 04:34:30.000,"Mike Bostock","Mike Bostock",4,4,8,0,27
2019-02-07 20:17:24.000,"Mike Bostock","Mike Bostock",1,1,2,0,5
2019-02-07 20:17:20.000,"Mike Bostock","Mike Bostock",6,2,8,0,14
2019-02-05 00:07:31.000,"Mike Bostock","Mike Bostock",1,1,2,0,5
2019-02-05 00:07:28.000,"Mike Bostock","Mike Bostock",2,2,4,0,15
2019-02-04 20:25:22.000,"Mike Bostock","Mike Bostock",1,1,2,0,5
2019-02-04 20:25:18.000,"Mike Bostock","Mike Bostock",2,2,4,0,16
2019-01-28 17:59:00.000,"Mike Bostock","Mike Bostock",1,1,2,0,5
2019-01-28 17:50:36.000,"Mike Bostock","Mike Bostock",30,15,45,0,20
2018-05-13 12:31:34.000,"denisname","Mike Bostock",11,8,19,0,145
2018-08-29 17:29:06.000,"nikolas","Mike Bostock",1,1,2,0,33
2018-08-24 22:48:27.000,"Mike Bostock","Mike Bostock",3,0,3,1,11
2018-08-24 22:43:31.000,"Mike Bostock","Mike Bostock",1,1,2,0,5
2018-08-24 22:43:24.000,"Mike Bostock","Mike Bostock",1,1,2,0,14
2018-08-24 22:41:41.000,"Mike Bostock","Mike Bostock",88,84,172,0,20
2018-08-20 22:06:06.000,"Mike Bostock","Mike Bostock",1,1,2,0,5
2018-08-20 22:05:57.000,"Mike Bostock","Mike Bostock",157,361,518,0,27
2018-06-16 19:08:06.000,"Mike Bostock","Mike Bostock",1,1,2,0,5
2018-06-16 19:07:51.000,"Mike Bostock","Mike Bostock",30,33,63,0,16
2018-05-11 20:28:39.000,"Mike Bostock","Mike Bostock",1,1,2,0,6
2018-05-11 20:27:54.000,"Mike Bostock","Mike Bostock",4,3,7,0,26
2018-05-09 15:40:33.000,"Mike Bostock","Mike Bostock",1,1,2,0,6
2018-05-09 15:39:37.000,"Mike Bostock","Mike Bostock",2,2,4,0,17
2018-05-07 18:30:39.000,"Mike Bostock","Mike Bostock",1,1,2,0,5
2018-05-07 18:27:53.000,"Mike Bostock","Mike Bostock",6,4,10,0,32
2018-05-03 09:41:00.000,"denisname","Mike Bostock",11,10,21,0,32
2018-04-17 21:54:26.000,"Mike Bostock","Mike Bostock",1,1,2,0,5
2018-04-17 21:54:20.000,"Mike Bostock","Mike Bostock",9,7,16,0,16
2018-04-17 16:36:00.000,"Mike Bostock","Mike Bostock",1,1,2,0,5
2018-04-17 16:35:53.000,"Mike Bostock","Mike Bostock",4,0,4,0,16
2018-04-16 17:23:09.000,"Mike Bostock","Mike Bostock",1,1,2,0,5
2018-04-16 17:22:56.000,"Mike Bostock","Mike Bostock",12,6,18,0,20
2018-03-31 01:19:38.000,"Mike Bostock","GitHub",1,1,2,0,13
2018-03-22 23:25:40.000,"Mike Bostock","GitHub",1,1,2,0,17
2018-03-22 23:24:57.000,"Mike Bostock","GitHub",1,1,2,0,17
2018-03-22 18:12:10.000,"Mike Bostock","Mike Bostock",1,1,2,0,15
2018-03-22 18:10:29.000,"Mike Bostock","Mike Bostock",1,1,2,0,15
2018-03-22 18:08:24.000,"Mike Bostock","Mike Bostock",4,0,4,0,15
2018-03-22 18:07:21.000,"Mike Bostock","Mike Bostock",4,4,8,0,15
2018-03-22 17:56:37.000,"Mike Bostock","Mike Bostock",1,0,1,2,11
2018-03-22 17:55:43.000,"Mike Bostock","Mike Bostock",36,0,36,1,15
2018-03-22 17:30:10.000,"Mike Bostock","Mike Bostock",337,21,358,0,5
2018-02-28 02:15:18.000,"Mike Bostock","Mike Bostock",23,29,52,0,10
2018-02-07 18:55:49.000,"Mike Bostock","Mike Bostock",0,1,1,0,16
2018-02-07 18:54:52.000,"Mike Bostock","Mike Bostock",91,89,180,0,11
2018-02-07 18:52:23.000,"Mike Bostock","Mike Bostock",1,17,18,3,29
2018-01-29 15:12:32.000,"Mike Bostock","Mike Bostock",67,67,134,0,31
2018-01-29 13:36:22.000,"Mike Bostock","Mike Bostock",489,0,489,0,14
2018-01-29 13:27:16.000,"Mike Bostock","Mike Bostock",8,6,14,0,11
2018-01-28 19:29:39.000,"Mike Bostock","Mike Bostock",4,1,5,0,26
2018-01-28 19:27:25.000,"Mike Bostock","Mike Bostock",1,1,2,0,11
2018-01-28 19:25:27.000,"Mike Bostock","Mike Bostock",146,58,204,0,26
2018-01-18 19:47:59.000,"Mike Bostock","Mike Bostock",1,1,2,0,14
2018-01-18 19:41:55.000,"zan","GitHub",1,1,2,0,521
2017-12-26 21:52:07.000,"Mike Bostock","Mike Bostock",1,1,2,1,6
2017-12-26 21:52:06.000,"Mike Bostock","Mike Bostock",1,1,2,2,24
2017-12-26 19:51:25.000,"Mike Bostock","Mike Bostock",1,1,2,0,6
2017-12-26 19:51:13.000,"Mike Bostock","Mike Bostock",5,5,10,0,28
2017-11-21 22:03:49.000,"Mike Bostock","Mike Bostock",1,1,2,0,6
2017-11-21 22:01:26.000,"Mike Bostock","Mike Bostock",15,11,26,0,20
2017-10-03 18:24:17.000,"Mike Bostock","Mike Bostock",1,1,2,0,6
2017-10-03 18:23:23.000,"Mike Bostock","Mike Bostock",20,7,27,0,20
2017-07-08 17:07:59.000,"alexmacy","Mike Bostock",2,2,4,0,13
2017-07-08 04:16:42.000,"alexmacy","Mike Bostock",1,1,2,0,14
2017-07-07 19:16:53.000,"alexmacy","Mike Bostock",23,22,45,0,218
2017-09-03 19:25:46.000,"Mike Bostock","Mike Bostock",1,1,2,0,6
2017-09-03 19:25:39.000,"Mike Bostock","Mike Bostock",1,1,2,0,16
2017-09-02 23:31:45.000,"Mike Bostock","Mike Bostock",1,1,2,0,6
2017-09-02 23:28:43.000,"Mike Bostock","Mike Bostock",16,12,28,0,169
2017-09-02 23:24:38.000,"Mike Bostock","Mike Bostock",0,511,511,0,25
2017-07-14 22:03:03.000,"Mike Bostock","Mike Bostock",2,2,4,0,6
2017-07-14 22:02:38.000,"Mike Bostock","Mike Bostock",530,13,543,0,20
2017-05-16 15:50:13.000,"Mike Bostock","Mike Bostock",1,1,2,0,5
2017-05-16 15:50:09.000,"Mike Bostock","Mike Bostock",2,2,4,0,20
2017-05-15 20:20:34.000,"Mike Bostock","Mike Bostock",1,1,2,0,5
2017-05-15 20:20:15.000,"Mike Bostock","Mike Bostock",32,12,44,0,7
2017-04-15 06:35:56.000,"Mike Bostock","Mike Bostock",1,1,2,0,5
2017-04-15 06:35:50.000,"Mike Bostock","Mike Bostock",4,3,7,0,20
2017-03-24 16:07:03.000,"Mike Bostock","Mike Bostock",1,1,2,0,5
2017-03-24 16:06:47.000,"Mike Bostock","Mike Bostock",1,1,2,0,15
2017-03-22 14:54:56.000,"Curran Kelleher","Mike Bostock",1,1,2,0,44
2017-03-13 16:10:29.000,"Mike Bostock","Mike Bostock",1,1,2,0,5
2017-03-13 16:10:02.000,"Mike Bostock","Mike Bostock",1,1,2,0,14
2017-03-10 18:29:59.000,"Mike Bostock","Mike Bostock",1,1,2,0,5
2017-03-10 18:29:16.000,"Mike Bostock","Mike Bostock",31,31,62,0,20
2017-03-02 20:35:19.000,"Mike Bostock","Mike Bostock",1,1,2,0,5
2017-03-02 20:34:48.000,"Mike Bostock","Mike Bostock",3,3,6,0,20
2017-02-28 20:22:40.000,"Mike Bostock","Mike Bostock",1,1,2,0,5
2017-02-28 20:19:34.000,"Mike Bostock","Mike Bostock",15,13,28,0,20
2017-02-19 17:07:47.000,"Mike Bostock","Mike Bostock",4,0,4,0,33
2017-02-19 17:00:37.000,"Mike Bostock","Mike Bostock",1,1,2,0,5
2017-02-19 17:00:16.000,"Mike Bostock","Mike Bostock",1,1,2,0,14
2017-02-19 16:31:32.000,"Mike Bostock","Mike Bostock",15,15,30,0,22
2017-02-18 17:18:16.000,"Mike Bostock","Mike Bostock",9,9,18,0,41
2017-02-18 17:17:29.000,"Mike Bostock","Mike Bostock",1,1,2,0,5
2017-02-18 17:17:25.000,"Mike Bostock","Mike Bostock",2,2,4,0,28
2017-02-15 22:28:09.000,"Elena Glassman","Mike Bostock",9,9,18,0,50
2017-01-29 05:37:09.000,"Mike Bostock","Mike Bostock",1,1,2,0,5
2017-01-29 05:37:01.000,"Mike Bostock","Mike Bostock",2,1,3,0,20
2017-01-26 21:07:18.000,"Mike Bostock","Mike Bostock",353,353,706,0,15
2017-01-26 21:04:56.000,"Mike Bostock","Mike Bostock",1,4,5,0,15
2017-01-26 19:57:08.000,"Micah Stubbs","GitHub",3,0,3,0,220
2017-01-26 18:01:49.000,"David Ollerhead","Mike Bostock",1,1,2,0,59
2017-01-23 18:49:16.000,"Mike Bostock","Mike Bostock",1,1,2,0,5
2017-01-23 18:49:13.000,"Mike Bostock","Mike Bostock",1,1,2,0,16
2017-01-20 23:14:39.000,"Mike Bostock","Mike Bostock",1,1,2,0,27
2017-01-20 23:11:32.000,"Mike Bostock","Mike Bostock",12,0,12,0,55
2017-01-20 23:09:13.000,"Mike Bostock","Mike Bostock",1,1,2,0,5
2017-01-20 23:09:01.000,"Mike Bostock","Mike Bostock",1,6,7,0,10
2017-01-18 10:00:38.000,"Mike Bostock","Mike Bostock",1,1,2,0,5
2017-01-18 10:00:25.000,"Mike Bostock","Mike Bostock",33,478,511,4,30
2017-01-06 17:12:26.000,"Mike Bostock","Mike Bostock",1,1,2,0,5
2017-01-06 17:12:05.000,"Mike Bostock","Mike Bostock",3,3,6,0,27
2016-11-23 01:31:45.000,"Mike Bostock","Mike Bostock",1,1,2,0,5
2016-11-23 01:13:48.000,"Mike Bostock","Mike Bostock",22,22,44,0,20
2016-11-22 02:53:45.000,"Peter Lenahan","Mike Bostock",2,2,4,0,92
2016-11-04 14:55:27.000,"Mike van Rossum","Mike Bostock",1,1,2,0,34
2016-11-04 14:34:27.000,"Mike van Rossum","Mike Bostock",1,1,2,0,20
2016-11-02 22:32:05.000,"Mike Bostock","Mike Bostock",12,0,12,0,14
2016-10-27 19:53:45.000,"Mike Bostock","Mike Bostock",61,44,105,0,25
2016-10-27 19:43:19.000,"Mike Bostock","Mike Bostock",1,1,2,0,5
2016-10-27 19:43:10.000,"Mike Bostock","Mike Bostock",5,3,8,0,20
2016-10-20 18:51:07.000,"Mike Bostock","Mike Bostock",3,3,6,0,41
2016-10-20 18:50:30.000,"Mike Bostock","Mike Bostock",1,1,2,0,5
2016-10-20 18:49:59.000,"Mike Bostock","Mike Bostock",1,1,2,0,20
2016-10-19 22:43:25.000,"Mike Bostock","GitHub",3,3,6,0,30
2016-10-11 16:54:56.000,"Mike Bostock","Mike Bostock",1,1,2,0,5
2016-10-11 16:54:51.000,"Mike Bostock","Mike Bostock",2,2,4,0,20
2016-10-07 17:09:57.000,"Mike Bostock","Mike Bostock",9,0,9,0,37
2016-09-22 18:30:22.000,"Mike Bostock","Mike Bostock",1,1,2,0,5
2016-09-22 18:30:06.000,"Mike Bostock","Mike Bostock",1,1,2,0,15
2016-09-20 21:12:56.000,"Mike Bostock","Mike Bostock",1,1,2,0,5
2016-09-20 21:12:52.000,"Mike Bostock","Mike Bostock",1,1,2,0,14
2016-09-19 21:43:03.000,"Fábio Silva","Mike Bostock",1,1,2,0,35
2016-09-19 19:55:44.000,"Mike Bostock","Mike Bostock",1,1,2,0,5
2016-09-19 19:55:39.000,"Mike Bostock","Mike Bostock",2,2,4,0,20
2016-09-19 19:54:01.000,"Mike Bostock","Mike Bostock",0,0,0,0,16
2016-09-19 17:11:00.000,"Mike Bostock","Mike Bostock",3,4,7,0,10
2016-09-19 16:52:43.000,"Mike Bostock","Mike Bostock",28,0,28,0,38
2016-09-13 00:35:35.000,"Mike Bostock","Mike Bostock",1,1,2,0,5
2016-09-13 00:35:30.000,"Mike Bostock","Mike Bostock",9,9,18,0,20
2016-09-11 15:56:34.000,"Mike Bostock","Mike Bostock",2,2,4,0,37
2016-08-30 20:26:38.000,"Mike Bostock","Mike Bostock",1,1,2,0,14
2016-08-30 20:25:30.000,"Mike Bostock","Mike Bostock",4,4,8,0,60
2016-08-30 17:46:24.000,"Jeferson Koslowski","Jeferson Koslowski",4,4,8,0,239
2016-08-16 05:21:49.000,"Mike Bostock","Mike Bostock",1,1,2,0,20
2016-08-16 05:19:25.000,"Mike Bostock","Mike Bostock",1,1,2,0,5
2016-08-16 05:19:18.000,"Mike Bostock","Mike Bostock",1,1,2,0,14
2016-08-11 16:47:25.000,"Mike Bostock","Mike Bostock",1,0,1,0,23
2016-08-07 15:58:26.000,"Mike Bostock","Mike Bostock",1,1,2,0,14
2016-08-07 15:52:32.000,"Mike Bostock","Mike Bostock",2,2,4,0,14
2016-08-07 15:51:27.000,"Mike Bostock","Mike Bostock",2,2,4,0,14
2016-08-07 15:50:53.000,"Mike Bostock","Mike Bostock",1,3,4,0,14
2016-08-07 15:49:47.000,"Mike Bostock","Mike Bostock",13,1,14,0,14
2016-08-03 01:42:13.000,"Mike Bostock","Mike Bostock",1,1,2,0,5
2016-08-03 01:42:07.000,"Mike Bostock","Mike Bostock",38,57,95,0,34
2016-07-30 00:02:36.000,"Mike Bostock","Mike Bostock",1,1,2,0,5
2016-07-30 00:02:32.000,"Mike Bostock","Mike Bostock",14,12,26,0,20
2016-07-29 14:50:44.000,"Mike Bostock","Mike Bostock",1,1,2,0,15
2016-07-26 21:30:38.000,"Barrie Treloar","Mike Bostock",1,1,2,0,30
2016-07-23 12:33:25.000,"william-pan","Mike Bostock",2,2,4,0,47
2016-07-18 19:56:57.000,"Mike Bostock","Mike Bostock",1,1,2,0,15
2016-07-18 19:54:59.000,"Mike Bostock","Mike Bostock",5,5,10,0,61
2016-07-18 17:57:27.000,"Gordon Woodhull","Gordon Woodhull",6,6,12,0,304
2016-07-14 00:44:59.000,"Dev-Lan","Mike Bostock",1,1,2,1,40
2016-07-11 03:47:51.000,"Mike Bostock","Mike Bostock",1,1,2,0,5
2016-07-11 03:47:46.000,"Mike Bostock","Mike Bostock",5,5,10,0,20
2016-07-08 23:50:10.000,"Mike Bostock","Mike Bostock",8,0,8,0,47
2016-07-02 06:27:51.000,"Mike Bostock","Mike Bostock",1,1,2,0,5
2016-07-01 22:10:07.000,"Mike Bostock","Mike Bostock",44,17,61,0,20
2016-07-01 22:02:24.000,"Mike Bostock","Mike Bostock",9,29,38,1,29
2016-07-01 14:59:51.000,"Curran Kelleher","Mike Bostock",1,1,2,0,53
2016-06-30 16:56:07.000,"Mike Bostock","Mike Bostock",2,0,2,0,15
2016-06-30 01:16:54.000,"Mike Bostock","Mike Bostock",1,1,2,0,37
2016-06-28 16:02:50.000,"Mike Bostock","Mike Bostock",1,1,2,0,18
2016-06-28 16:01:50.000,"Mike Bostock","Mike Bostock",1,1,2,1,5
2016-06-28 16:00:33.000,"Mike Bostock","Mike Bostock",13,16,29,0,26
2016-06-27 23:10:27.000,"Mike Bostock","Mike Bostock",1,1,2,0,11
2016-06-27 23:09:09.000,"Mike Bostock","Mike Bostock",1,1,2,0,26
2016-06-27 19:47:41.000,"Mike Bostock","Mike Bostock",900,900,1800,0,24
2016-06-27 19:28:46.000,"Mike Bostock","GitHub",57,57,114,0,79
2016-06-27 19:22:20.000,"mpersing","GitHub",57,57,114,0,31
2016-06-25 22:19:18.000,"Mike Bostock","Mike Bostock",25,25,50,0,11
2016-06-25 22:15:40.000,"Mike Bostock","Mike Bostock",11,11,22,0,11
2016-06-25 22:13:34.000,"Mike Bostock","Mike Bostock",6,6,12,0,11
2016-06-25 22:12:27.000,"Mike Bostock","Mike Bostock",5,5,10,0,11
2016-06-25 22:11:00.000,"Mike Bostock","Mike Bostock",64,64,128,0,11
2016-06-25 21:48:51.000,"Mike Bostock","Mike Bostock",1,3,4,0,15
2016-06-25 17:32:52.000,"Mike Bostock","Mike Bostock",6,5,11,0,11
2016-06-25 17:31:50.000,"Mike Bostock","Mike Bostock",11,0,11,0,11
2016-06-25 17:27:16.000,"Mike Bostock","Mike Bostock",1,0,1,0,11
2016-06-25 17:23:06.000,"Mike Bostock","Mike Bostock",2,2,4,0,11
2016-06-25 17:21:20.000,"Mike Bostock","Mike Bostock",14,14,28,0,11
2016-06-25 17:20:23.000,"Mike Bostock","Mike Bostock",34,10,44,0,11
2016-06-25 17:10:38.000,"Mike Bostock","Mike Bostock",16,15,31,0,11
2016-06-25 17:09:27.000,"Mike Bostock","Mike Bostock",1,4,5,0,11
2016-06-25 17:07:29.000,"Mike Bostock","Mike Bostock",19,19,38,0,11
2016-06-25 17:03:51.000,"Mike Bostock","Mike Bostock",38,25,63,0,11
2016-06-25 16:16:09.000,"Mike Bostock","Mike Bostock",7,7,14,0,23
2016-06-25 00:34:00.000,"Mike Bostock","Mike Bostock",23,21,44,0,24
2016-06-24 18:29:30.000,"Mike Bostock","Mike Bostock",1,3,4,0,15
2016-06-24 18:24:55.000,"Mike Bostock","Mike Bostock",2,2,4,0,15
2016-06-24 18:24:37.000,"Mike Bostock","Mike Bostock",2,2,4,0,15
2016-06-24 18:24:02.000,"Mike Bostock","Mike Bostock",36,11,47,0,15
2016-06-24 18:15:15.000,"Mike Bostock","Mike Bostock",1,3,4,0,15
2016-06-24 18:14:29.000,"Mike Bostock","Mike Bostock",2,2,4,0,15
2016-06-24 18:13:24.000,"Mike Bostock","Mike Bostock",7,1,8,0,15
2016-06-24 18:11:57.000,"Mike Bostock","Mike Bostock",2,4,6,0,15
2016-06-24 18:09:19.000,"Mike Bostock","Mike Bostock",18,10,28,0,15
2016-06-24 18:00:15.000,"Mike Bostock","Mike Bostock",1,3,4,0,15
2016-06-24 17:59:57.000,"Mike Bostock","Mike Bostock",18,20,38,0,15
2016-06-24 17:45:19.000,"Mike Bostock","Mike Bostock",24,22,46,0,15
2016-06-24 17:29:34.000,"Mike Bostock","Mike Bostock",1,1,2,0,14
2016-06-24 17:26:47.000,"Mike Bostock","Mike Bostock",29,14,43,0,15
2016-06-24 17:12:28.000,"Mike Bostock","Mike Bostock",17,8,25,0,14
2016-06-24 16:47:50.000,"Mike Bostock","Mike Bostock",5,0,5,0,11
2016-06-24 05:41:34.000,"Mike Bostock","Mike Bostock",2,4,6,0,15
2016-06-24 05:38:11.000,"Mike Bostock","Mike Bostock",24,19,43,0,15
2016-06-24 02:01:10.000,"Mike Bostock","Mike Bostock",16,4,20,0,15
2016-06-24 01:56:26.000,"Mike Bostock","Mike Bostock",15,1,16,0,15
2016-06-24 01:55:03.000,"Mike Bostock","Mike Bostock",1,1,2,0,15
2016-06-24 01:54:35.000,"Mike Bostock","Mike Bostock",1,1,2,0,15
2016-06-24 01:53:29.000,"Mike Bostock","Mike Bostock",8,10,18,0,15
2016-06-24 01:36:45.000,"Mike Bostock","Mike Bostock",29,24,53,0,15
2016-06-24 01:30:11.000,"Mike Bostock","Mike Bostock",2,2,4,0,15
2016-06-24 01:28:11.000,"Mike Bostock","Mike Bostock",1,1,2,0,15
2016-06-24 01:27:25.000,"Mike Bostock","Mike Bostock",1,1,2,0,15
2016-06-24 01:26:57.000,"Mike Bostock","Mike Bostock",1,1,2,0,15
2016-06-24 01:26:48.000,"Mike Bostock","Mike Bostock",1,1,2,0,15
2016-06-24 01:15:13.000,"Mike Bostock","Mike Bostock",2,2,4,0,15
2016-06-24 01:13:46.000,"Mike Bostock","Mike Bostock",1,1,2,0,15
2016-06-24 01:13:03.000,"Mike Bostock","Mike Bostock",2,2,4,0,15
2016-06-24 01:12:09.000,"Mike Bostock","Mike Bostock",2,4,6,0,15
2016-06-24 01:11:27.000,"Mike Bostock","Mike Bostock",1,3,4,0,15
2016-06-24 01:10:15.000,"Mike Bostock","Mike Bostock",10,8,18,0,15
2016-06-24 01:04:31.000,"Mike Bostock","Mike Bostock",33,36,69,0,15
2016-06-24 01:02:54.000,"Mike Bostock","Mike Bostock",1,1,2,0,11
2016-06-24 01:00:49.000,"Mike Bostock","Mike Bostock",1105,1099,2204,0,33
2016-06-24 00:56:24.000,"Mike Bostock","Mike Bostock",3,1,4,0,15
2016-06-23 23:37:41.000,"Mike Bostock","Mike Bostock",2,2,4,0,15
2016-06-23 23:35:53.000,"Mike Bostock","Mike Bostock",1,3,4,0,15
2016-06-23 23:35:06.000,"Mike Bostock","Mike Bostock",3,3,6,0,15
2016-06-23 23:33:35.000,"Mike Bostock","Mike Bostock",53,9,62,0,15
2016-06-23 23:20:55.000,"Mike Bostock","Mike Bostock",40,15,55,0,15
2016-06-23 23:13:17.000,"Mike Bostock","Mike Bostock",1,1,2,0,15
2016-06-23 23:13:05.000,"Mike Bostock","Mike Bostock",2,2,4,0,15
2016-06-23 23:11:47.000,"Mike Bostock","Mike Bostock",2,2,4,0,15
2016-06-23 23:10:20.000,"Mike Bostock","Mike Bostock",3,3,6,0,15
2016-06-23 23:03:58.000,"Mike Bostock","Mike Bostock",3,3,6,0,15
2016-06-23 23:03:27.000,"Mike Bostock","Mike Bostock",12,2,14,0,15
2016-06-23 23:02:34.000,"Mike Bostock","Mike Bostock",1,8,9,0,15
2016-06-23 23:01:22.000,"Mike Bostock","Mike Bostock",15,6,21,0,15
2016-06-23 22:05:45.000,"Mike Bostock","Mike Bostock",1,1,2,0,15
2016-06-23 22:02:59.000,"Mike Bostock","Mike Bostock",9,0,9,0,15
2016-06-23 05:36:43.000,"Mike Bostock","Mike Bostock",17,14,31,0,15
2016-06-22 23:53:40.000,"Mike Bostock","Mike Bostock",2,2,4,0,15
2016-06-22 23:53:25.000,"Mike Bostock","Mike Bostock",2,2,4,0,15
2016-06-22 23:53:02.000,"Mike Bostock","Mike Bostock",20,15,35,0,15
2016-06-22 21:29:40.000,"Mike Bostock","Mike Bostock",2,4,6,0,15
2016-06-22 21:13:58.000,"Mike Bostock","Mike Bostock",1,1,2,0,15
2016-06-22 21:13:45.000,"Mike Bostock","Mike Bostock",2,2,4,0,15
2016-06-22 21:08:50.000,"Mike Bostock","Mike Bostock",6,4,10,0,15
2016-06-22 21:08:49.000,"Mike Bostock","Mike Bostock",0,0,0,3,16
2016-06-22 20:55:06.000,"Mike Bostock","Mike Bostock",1,1,2,0,15
2016-06-22 20:54:37.000,"Mike Bostock","Mike Bostock",1,1,2,0,15
2016-06-22 20:54:29.000,"Mike Bostock","Mike Bostock",1,1,2,0,15
2016-06-22 20:53:53.000,"Mike Bostock","Mike Bostock",7,12,19,0,15
2016-06-22 20:44:08.000,"Mike Bostock","Mike Bostock",2,2,4,0,15
2016-06-22 20:43:13.000,"Mike Bostock","Mike Bostock",6,4,10,0,15
2016-06-22 20:25:04.000,"Mike Bostock","Mike Bostock",6,8,14,0,15
2016-06-22 19:56:38.000,"Mike Bostock","Mike Bostock",1,1,2,0,15
2016-06-22 19:56:34.000,"Mike Bostock","Mike Bostock",1,1,2,0,15
2016-06-22 19:56:29.000,"Mike Bostock","Mike Bostock",1,1,2,0,15
2016-06-22 19:53:46.000,"Mike Bostock","Mike Bostock",1,1,2,0,15
2016-06-22 19:52:05.000,"Mike Bostock","Mike Bostock",1,2,3,0,15
2016-06-22 19:50:40.000,"Mike Bostock","Mike Bostock",1,1,2,0,15
2016-06-22 19:49:52.000,"Mike Bostock","Mike Bostock",59,23,82,0,15
2016-06-22 19:48:49.000,"Mike Bostock","Mike Bostock",0,0,0,0,17
2016-06-22 18:50:11.000,"Mike Bostock","Mike Bostock",1,0,1,0,15
2016-06-22 18:48:38.000,"Mike Bostock","Mike Bostock",6,4,10,0,15
2016-06-22 05:26:34.000,"Mike Bostock","Mike Bostock",1,1,2,0,15
2016-06-22 05:26:23.000,"Mike Bostock","Mike Bostock",1,1,2,0,15
2016-06-22 05:24:44.000,"Mike Bostock","Mike Bostock",2,8,10,0,15
2016-06-22 00:55:40.000,"Mike Bostock","Mike Bostock",12,7,19,0,15
2016-06-21 23:23:57.000,"Mike Bostock","Mike Bostock",40,51,91,0,15
2016-06-21 22:50:03.000,"Mike Bostock","Mike Bostock",4,4,8,0,15
2016-06-21 22:47:46.000,"Mike Bostock","Mike Bostock",39,20,59,0,15
2016-06-21 19:38:30.000,"Mike Bostock","Mike Bostock",4,4,8,0,15
2016-06-21 19:35:39.000,"Mike Bostock","Mike Bostock",12,6,18,0,15
2016-06-21 19:20:42.000,"Mike Bostock","Mike Bostock",32,1,33,0,15
2016-06-20 23:41:00.000,"Mike Bostock","Mike Bostock",1,3,4,0,15
2016-06-20 23:40:26.000,"Mike Bostock","Mike Bostock",1,1,2,0,15
2016-06-20 23:40:09.000,"Mike Bostock","Mike Bostock",1,1,2,0,15
2016-06-20 23:39:50.000,"Mike Bostock","Mike Bostock",2,2,4,0,15
2016-06-20 23:39:08.000,"Mike Bostock","Mike Bostock",1,1,2,0,15
2016-06-20 23:38:42.000,"Mike Bostock","Mike Bostock",1,1,2,0,15
2016-06-20 23:38:15.000,"Mike Bostock","Mike Bostock",1,1,2,0,15
2016-06-20 23:36:20.000,"Mike Bostock","Mike Bostock",8,34,42,0,15
2016-06-20 20:32:58.000,"Mike Bostock","Mike Bostock",9,24,33,0,15
2016-06-20 20:11:31.000,"Mike Bostock","Mike Bostock",1,1,2,0,15
2016-06-20 20:11:10.000,"Mike Bostock","Mike Bostock",3,3,6,0,15
2016-06-20 20:09:10.000,"Mike Bostock","Mike Bostock",7,12,19,0,15
2016-06-20 19:47:13.000,"Mike Bostock","Mike Bostock",1,1,2,0,15
2016-06-20 19:43:39.000,"Mike Bostock","Mike Bostock",1,1,2,0,15
2016-06-20 19:42:44.000,"Mike Bostock","Mike Bostock",1,3,4,0,15
2016-06-20 19:40:43.000,"Mike Bostock","Mike Bostock",20,15,35,0,15
2016-06-19 18:03:18.000,"Mike Bostock","Mike Bostock",6,8,14,0,14
2016-06-19 17:54:00.000,"Mike Bostock","Mike Bostock",5,5,10,0,14
2016-06-19 17:52:30.000,"Mike Bostock","Mike Bostock",115,27,142,0,32
2016-06-16 00:21:40.000,"Mike Bostock","Mike Bostock",2,2,4,0,15
2016-06-16 00:19:34.000,"Mike Bostock","Mike Bostock",6,10,16,0,15
2016-06-15 19:42:50.000,"Mike Bostock","Mike Bostock",4,4,8,0,15
2016-06-15 19:41:22.000,"Mike Bostock","Mike Bostock",1,1,2,0,15
2016-06-15 19:41:07.000,"Mike Bostock","Mike Bostock",1,1,2,0,15
2016-06-15 19:40:11.000,"Mike Bostock","Mike Bostock",34,13,47,0,15
2016-06-15 18:55:15.000,"Mike Bostock","Mike Bostock",4,8,12,0,15
2016-06-15 18:07:35.000,"Mike Bostock","Mike Bostock",0,2,2,0,15
2016-06-15 18:06:57.000,"Mike Bostock","Mike Bostock",1,1,2,0,14
2016-06-15 17:30:05.000,"Mike Bostock","Mike Bostock",3,3,6,0,15
2016-06-15 17:29:33.000,"Mike Bostock","Mike Bostock",7,9,16,0,15
2016-06-15 17:23:58.000,"Mike Bostock","Mike Bostock",21,31,52,0,15
2016-06-15 16:52:32.000,"Mike Bostock","Mike Bostock",1,1,2,0,15
2016-06-15 16:55:36.000,"Mike Bostock","Mike Bostock",8,4,12,0,15
2016-06-15 00:32:08.000,"Mike Bostock","Mike Bostock",2,2,4,0,15
2016-06-15 00:30:42.000,"Mike Bostock","Mike Bostock",1,1,2,0,15
2016-06-15 00:30:26.000,"Mike Bostock","Mike Bostock",2,2,4,0,15
2016-06-15 00:28:49.000,"Mike Bostock","Mike Bostock",49,21,70,0,15
2016-06-15 00:13:36.000,"Mike Bostock","Mike Bostock",1,1,2,0,15
2016-06-15 00:12:49.000,"Mike Bostock","Mike Bostock",119,95,214,0,15
2016-06-14 21:59:31.000,"Mike Bostock","Mike Bostock",47,57,104,0,15
2016-06-14 21:42:30.000,"Mike Bostock","Mike Bostock",1,1,2,0,15
2016-06-14 21:41:50.000,"Mike Bostock","Mike Bostock",2,7,9,0,15
2016-06-14 21:39:08.000,"Mike Bostock","Mike Bostock",7,8,15,0,15
2016-06-14 21:35:31.000,"Mike Bostock","Mike Bostock",17,2,19,0,15
2016-06-14 21:30:47.000,"Mike Bostock","Mike Bostock",2,2,4,0,15
2016-06-14 21:29:14.000,"Mike Bostock","Mike Bostock",1,1,2,0,15
2016-06-14 21:28:57.000,"Mike Bostock","Mike Bostock",2,2,4,0,15
2016-06-14 21:28:20.000,"Mike Bostock","Mike Bostock",3,3,6,0,15
2016-06-14 21:27:07.000,"Mike Bostock","Mike Bostock",54,8,62,0,15
2016-06-14 20:48:52.000,"Mike Bostock","Mike Bostock",3,3,6,0,15
2016-06-14 20:47:49.000,"Mike Bostock","Mike Bostock",61,55,116,0,15
2016-06-14 19:44:08.000,"Mike Bostock","Mike Bostock",2,2,4,0,15
2016-06-14 19:24:29.000,"Mike Bostock","Mike Bostock",1,1,2,0,15
2016-06-14 19:21:51.000,"Mike Bostock","Mike Bostock",27,25,52,0,15
2016-06-14 19:02:07.000,"Mike Bostock","Mike Bostock",17,11,28,0,15
2016-06-14 18:52:56.000,"Mike Bostock","Mike Bostock",1,3,4,0,15
2016-06-14 18:28:04.000,"Mike Bostock","Mike Bostock",3,2,5,0,15
2016-06-14 18:15:15.000,"Mike Bostock","Mike Bostock",13,13,26,0,15
2016-06-14 18:10:18.000,"Mike Bostock","Mike Bostock",5,3,8,0,15
2016-06-14 18:08:09.000,"Mike Bostock","Mike Bostock",1,3,4,0,15
2016-06-14 18:07:35.000,"Mike Bostock","Mike Bostock",71,9,80,0,15
2016-06-14 17:45:46.000,"Mike Bostock","Mike Bostock",0,1,1,0,15
2016-06-14 00:56:53.000,"Mike Bostock","Mike Bostock",1,0,1,0,15
2016-06-14 00:16:16.000,"Mike Bostock","Mike Bostock",14,14,28,0,15
2016-06-14 00:09:15.000,"Mike Bostock","Mike Bostock",1,11,12,0,15
2016-06-14 00:05:32.000,"Mike Bostock","Mike Bostock",2,2,4,0,15
2016-06-14 00:04:19.000,"Mike Bostock","Mike Bostock",3,5,8,0,15
2016-06-14 00:03:44.000,"Mike Bostock","Mike Bostock",2,2,4,0,15
2016-06-14 00:03:18.000,"Mike Bostock","Mike Bostock",54,36,90,0,15
2016-06-13 23:47:27.000,"Mike Bostock","Mike Bostock",1,1,2,0,15
2016-06-13 23:47:09.000,"Mike Bostock","Mike Bostock",3,3,6,0,15
2016-06-13 23:46:22.000,"Mike Bostock","Mike Bostock",1,3,4,0,15
2016-06-13 23:46:06.000,"Mike Bostock","Mike Bostock",3,1,4,0,15
2016-06-13 23:45:28.000,"Mike Bostock","Mike Bostock",20,13,33,0,15
2016-06-13 22:32:09.000,"Mike Bostock","Mike Bostock",1,0,1,0,15
2016-06-13 22:30:42.000,"Mike Bostock","Mike Bostock",1,1,2,0,15
2016-06-13 22:29:44.000,"Mike Bostock","Mike Bostock",2,2,4,0,15
2016-06-13 22:29:08.000,"Mike Bostock","Mike Bostock",23,9,32,0,15
2016-06-13 22:16:22.000,"Mike Bostock","Mike Bostock",3,3,6,0,15
2016-06-13 22:14:43.000,"Mike Bostock","Mike Bostock",7,1,8,0,15
2016-06-13 22:13:06.000,"Mike Bostock","Mike Bostock",2,2,4,0,15
2016-06-13 22:12:09.000,"Mike Bostock","Mike Bostock",6,23,29,0,15
2016-06-13 21:34:16.000,"Mike Bostock","Mike Bostock",6,6,12,0,15
2016-06-13 21:26:31.000,"Mike Bostock","Mike Bostock",20,8,28,0,15
2016-06-13 21:22:07.000,"Mike Bostock","Mike Bostock",1,1,2,0,15
2016-06-13 21:20:12.000,"Mike Bostock","Mike Bostock",2,2,4,0,15
2016-06-13 21:18:30.000,"Mike Bostock","Mike Bostock",1,1,2,0,15
2016-06-13 21:18:05.000,"Mike Bostock","Mike Bostock",7,14,21,0,15
2016-06-13 20:36:08.000,"Mike Bostock","Mike Bostock",0,1,1,0,15
2016-06-13 20:35:38.000,"Mike Bostock","Mike Bostock",2,2,4,0,15
2016-06-13 20:34:17.000,"Mike Bostock","Mike Bostock",0,7,7,0,15
2016-06-13 20:31:48.000,"Mike Bostock","Mike Bostock",19,0,19,0,15
2016-06-13 20:16:42.000,"Mike Bostock","Mike Bostock",8,0,8,0,15
2016-06-13 20:08:44.000,"Mike Bostock","Mike Bostock",3,0,3,0,15
2016-06-13 20:06:16.000,"Mike Bostock","Mike Bostock",19,3,22,0,15
2016-06-13 19:50:28.000,"Mike Bostock","Mike Bostock",64,45,109,0,15
2016-06-13 19:43:33.000,"Mike Bostock","Mike Bostock",5,2,7,0,15
2016-06-13 19:40:15.000,"Mike Bostock","Mike Bostock",6,0,6,0,15
2016-06-13 19:40:06.000,"Mike Bostock","GitHub",1,1,2,0,81
2016-06-13 19:36:34.000,"Curran Kelleher","GitHub",1,1,2,0,107
2016-06-13 19:29:42.000,"Mike Bostock","GitHub",1,1,2,0,78
2016-06-13 19:29:10.000,"Mike Bostock","Mike Bostock",62,2,64,0,15
2016-06-13 19:25:02.000,"Curran Kelleher","GitHub",1,1,2,0,248
2016-06-13 19:10:56.000,"Mike Bostock","Mike Bostock",25,4,29,0,15
2016-06-13 17:02:13.000,"Mike Bostock","Mike Bostock",57,51,108,0,15
2016-06-11 16:47:20.000,"Mike Bostock","Mike Bostock",34,3,37,0,15
2016-06-11 06:17:49.000,"Mike Bostock","Mike Bostock",18,12,30,0,15
2016-06-11 01:16:16.000,"Mike Bostock","Mike Bostock",20,0,20,0,15
2016-06-11 00:57:22.000,"Mike Bostock","Mike Bostock",36,1,37,0,15
2016-06-11 00:40:10.000,"Mike Bostock","Mike Bostock",66,6,72,0,15
2016-06-10 23:10:17.000,"Mike Bostock","Mike Bostock",1,1,2,0,15
2016-06-10 23:09:57.000,"Mike Bostock","Mike Bostock",1,1,2,0,15
2016-06-10 23:05:55.000,"Mike Bostock","Mike Bostock",12,0,12,0,15
2016-06-10 22:58:26.000,"Mike Bostock","Mike Bostock",32,30,62,0,15
2016-06-10 22:43:08.000,"Mike Bostock","Mike Bostock",60,22,82,0,15
2016-06-10 22:17:32.000,"Mike Bostock","Mike Bostock",65,1,66,0,15
2016-06-10 18:04:32.000,"Mike Bostock","Mike Bostock",5,5,10,0,9
2016-06-10 17:58:01.000,"Mike Bostock","Mike Bostock",7,7,14,0,9
2016-06-10 17:11:37.000,"Mike Bostock","Mike Bostock",5,5,10,0,9
2016-06-10 16:52:03.000,"Mike Bostock","Mike Bostock",7,7,14,0,9
2016-06-10 01:42:59.000,"Mike Bostock","Mike Bostock",11,1,12,0,15
2016-06-10 01:26:52.000,"Mike Bostock","Mike Bostock",17,2,19,0,15
2016-06-10 01:05:19.000,"Mike Bostock","Mike Bostock",1,1,2,0,15
2016-06-10 01:03:45.000,"Mike Bostock","Mike Bostock",2,2,4,0,15
2016-06-10 01:01:51.000,"Mike Bostock","Mike Bostock",64,38,102,0,15
2016-06-10 00:54:31.000,"Mike Bostock","Mike Bostock",76,8,84,0,15
2016-06-09 23:28:39.000,"Mike Bostock","Mike Bostock",17,0,17,0,15
2016-06-09 23:21:11.000,"Mike Bostock","Mike Bostock",2,5,7,0,15
2016-06-09 23:16:20.000,"Mike Bostock","Mike Bostock",7,11,18,0,15
2016-06-09 23:02:03.000,"Mike Bostock","Mike Bostock",1,1,2,0,15
2016-06-09 22:56:11.000,"Mike Bostock","Mike Bostock",51,3,54,0,15
2016-06-09 22:54:45.000,"Mike Bostock","Mike Bostock",0,0,0,0,11
2016-06-09 22:44:51.000,"Mike Bostock","Mike Bostock",1,3,4,2,15
2016-06-09 22:43:38.000,"Mike Bostock","Mike Bostock",1,5,6,0,15
2016-06-09 22:43:12.000,"Mike Bostock","Mike Bostock",26,5,31,0,15
2016-06-09 22:22:18.000,"Mike Bostock","Mike Bostock",6,4,10,0,15
2016-06-09 21:10:26.000,"Mike Bostock","Mike Bostock",5,5,10,0,15
2016-06-09 21:07:31.000,"Mike Bostock","Mike Bostock",3,1,4,0,26
2016-06-09 18:57:17.000,"Mike Bostock","Mike Bostock",5,5,10,0,15
2016-06-08 23:46:49.000,"Mike Bostock","Mike Bostock",18,2,20,0,15
2016-06-08 23:43:54.000,"Mike Bostock","Mike Bostock",2,2,4,0,15
2016-06-08 23:43:19.000,"Mike Bostock","Mike Bostock",9,6,15,0,15
2016-06-08 21:06:07.000,"Mike Bostock","Mike Bostock",9,9,18,0,15
2016-06-08 20:14:11.000,"Mike Bostock","Mike Bostock",1,1,2,0,15
2016-06-08 20:11:25.000,"Mike Bostock","Mike Bostock",2,0,2,0,15
2016-06-08 20:10:41.000,"Mike Bostock","Mike Bostock",7,1,8,0,15
2016-06-08 20:04:44.000,"Mike Bostock","Mike Bostock",4,4,8,0,15
2016-06-08 20:01:57.000,"Mike Bostock","Mike Bostock",27,1,28,0,15
2016-06-08 19:53:10.000,"Mike Bostock","Mike Bostock",24,3,27,0,15
2016-06-08 19:36:40.000,"Mike Bostock","Mike Bostock",1,1,2,0,15
2016-06-08 19:36:22.000,"Mike Bostock","Mike Bostock",88,66,154,0,15
2016-06-08 19:32:09.000,"Mike Bostock","Mike Bostock",15,15,30,0,14
2016-06-08 19:29:53.000,"Mike Bostock","Mike Bostock",2,2,4,0,15
2016-06-08 19:16:46.000,"Mike Bostock","Mike Bostock",1,1,2,0,15
2016-06-08 19:16:13.000,"Mike Bostock","Mike Bostock",147,147,294,0,15
2016-06-08 19:15:42.000,"Mike Bostock","Mike Bostock",5,5,10,0,15
2016-06-08 19:09:21.000,"Mike Bostock","Mike Bostock",222,0,222,0,17
2016-06-08 18:18:06.000,"Mike Bostock","Mike Bostock",1,1,2,0,14
2016-06-08 06:00:06.000,"Mike Bostock","Mike Bostock",1,1,2,0,14
2016-06-08 05:53:27.000,"Mike Bostock","Mike Bostock",0,1,1,0,14
2016-06-08 05:43:51.000,"Mike Bostock","Mike Bostock",111,149,260,0,9
2016-06-01 00:07:57.000,"Mike Bostock","Mike Bostock",27,26,53,0,18
2016-05-26 17:05:28.000,"Mike Bostock","Mike Bostock",3,3,6,0,15
2016-05-26 16:58:26.000,"Mike Bostock","Mike Bostock",47,1,48,0,20
2016-05-26 16:51:30.000,"Mike Bostock","Mike Bostock",3,1,4,0,28
2016-05-26 06:22:55.000,"Mike Bostock","Mike Bostock",3,3,6,0,15
2016-05-26 01:01:19.000,"Mike Bostock","Mike Bostock",8,5,13,0,24
2016-05-24 23:55:28.000,"Mike Bostock","Mike Bostock",57,25,82,0,9
2016-05-22 06:02:22.000,"Mike Bostock","Mike Bostock",28,26,54,0,44
2016-05-18 22:05:28.000,"Mike Bostock","Mike Bostock",1,1,2,0,30
2016-05-15 06:05:58.000,"Mike Bostock","Mike Bostock",1,1,2,0,14
2016-05-13 19:16:18.000,"Mike Bostock","Mike Bostock",4,3,7,0,16
2016-05-13 18:44:24.000,"Mike Bostock","Mike Bostock",1,1,2,0,14
2016-05-13 17:20:56.000,"Mike Bostock","Mike Bostock",1,1,2,0,14
2016-05-13 17:18:34.000,"Mike Bostock","Mike Bostock",3,5,8,0,14
2016-05-13 17:16:17.000,"Mike Bostock","Mike Bostock",1622,49840,51462,0,16
2016-05-13 16:50:10.000,"Mike Bostock","Mike Bostock",1,1,2,0,16
2016-05-12 21:44:17.000,"Mike Bostock","Mike Bostock",3,3,6,0,16
2016-05-12 00:46:45.000,"Mike Bostock","Mike Bostock",3,3,6,0,15
2016-05-11 16:51:08.000,"Mike Bostock","Mike Bostock",7,2,9,0,31
2016-05-11 16:44:04.000,"Mike Bostock","Mike Bostock",25,4,29,0,7
2016-05-05 01:31:01.000,"Mike Bostock","Mike Bostock",9,9,18,0,23
2016-05-05 01:29:22.000,"Mike Bostock","Mike Bostock",1,1,2,0,6
2016-05-05 01:28:56.000,"Mike Bostock","Mike Bostock",1,1,2,0,18
2016-05-05 01:27:30.000,"Mike Bostock","Mike Bostock",1,1,2,0,61
2016-05-05 01:23:42.000,"Mike Bostock","Mike Bostock",1,1,2,0,17
2016-05-03 19:30:04.000,"Mike Bostock","Mike Bostock",7,7,14,0,20
2016-05-02 21:44:35.000,"Mike Bostock","Mike Bostock",6,1,7,0,33
2016-05-02 17:27:46.000,"Mike Bostock","Mike Bostock",5,5,10,0,7
2016-04-29 19:22:34.000,"Mike Bostock","Mike Bostock",3,3,6,0,16
2016-04-29 18:51:52.000,"Mike Bostock","Mike Bostock",12,9,21,0,16
2016-04-29 17:12:01.000,"Mike Bostock","Mike Bostock",3,3,6,0,16
2016-04-29 00:00:57.000,"Mike Bostock","Mike Bostock",1,0,1,0,14
2016-04-28 23:58:41.000,"Mike Bostock","Mike Bostock",66,12,78,0,7
2016-04-25 23:27:17.000,"Mike Bostock","Mike Bostock",1,1,2,0,14
2016-04-25 23:26:55.000,"Mike Bostock","Mike Bostock",2,2,4,0,14
2016-04-25 23:25:15.000,"Mike Bostock","Mike Bostock",4,0,4,0,23
2016-04-20 15:19:57.000,"Mike Bostock","Mike Bostock",123,3,126,0,71
2016-04-20 13:00:33.000,"Minwei Xu","Minwei Xu",6,6,12,0,7
2016-04-20 12:52:05.000,"Minwei Xu","Minwei Xu",122,2,124,0,11
2016-04-01 22:39:50.000,"Mike Bostock","Mike Bostock",81,2,83,0,17
2016-03-31 23:00:02.000,"Lukas Appelhans","Lukas Appelhans",1,1,2,0,18
2016-03-15 17:20:44.000,"Mike Bostock","Mike Bostock",1,1,2,0,9
2016-03-14 20:15:17.000,"Mike Bostock","Mike Bostock",1,2,3,0,12
2016-03-14 19:25:49.000,"Mike Bostock","Mike Bostock",56,12,68,0,92
2016-03-11 18:54:29.000,"Mike Bostock","Mike Bostock",26,24,50,0,10
2016-03-08 04:14:04.000,"Mike Bostock","Mike Bostock",3,3,6,0,16
2016-03-06 23:08:16.000,"Mike Bostock","Mike Bostock",1,1,2,0,16
2016-03-06 23:06:59.000,"Mike Bostock","Mike Bostock",4,4,8,0,7
2016-03-04 17:54:11.000,"Mike Bostock","Mike Bostock",2,2,4,0,30
2016-03-03 06:09:48.000,"Mike Bostock","Mike Bostock",4,4,8,0,20
2016-03-02 23:12:32.000,"Mike Bostock","Mike Bostock",3,3,6,0,21
2016-03-02 17:14:38.000,"Mike Bostock","Mike Bostock",1,0,1,0,25
2016-03-02 17:13:41.000,"Mike Bostock","Mike Bostock",2,0,2,0,18
2016-03-02 17:11:56.000,"Mike Bostock","Mike Bostock",3,1,4,0,18
2016-03-02 00:07:30.000,"Mike Bostock","Mike Bostock",1,1,2,0,7
2016-03-01 21:31:01.000,"Mike Bostock","Mike Bostock",5,6,11,0,658
2016-02-29 23:55:55.000,"Mike Bostock","Mike Bostock",1,1,2,0,15
2016-02-29 19:50:30.000,"Mike Bostock","Mike Bostock",1,1,2,0,31
2016-02-28 17:37:40.000,"Mike Bostock","Mike Bostock",0,1,1,0,14
2016-02-28 17:37:03.000,"Mike Bostock","Mike Bostock",5,6,11,0,20
2016-02-26 23:30:24.000,"Mike Bostock","Mike Bostock",3,3,6,0,21
2016-02-26 21:46:19.000,"Mike Bostock","Mike Bostock",9,7,16,0,20
2016-02-26 18:18:09.000,"Mike Bostock","Mike Bostock",2,2,4,0,14
2016-02-24 05:39:06.000,"Mike Bostock","Mike Bostock",4,4,8,0,30
2016-02-24 03:43:07.000,"Mike Bostock","Mike Bostock",1,1,2,0,15
2016-02-23 04:53:39.000,"Mike Bostock","Mike Bostock",3,3,6,0,21
2016-02-23 04:15:40.000,"Mike Bostock","Mike Bostock",4,4,8,0,26
2016-02-22 23:56:43.000,"Mike Bostock","Mike Bostock",2,2,4,0,13
2016-02-22 23:56:27.000,"Mike Bostock","Mike Bostock",3,3,6,0,20
2016-02-22 17:25:18.000,"Mike Bostock","Mike Bostock",1,1,2,0,16
2016-02-22 17:05:50.000,"Mike Bostock","Mike Bostock",8,8,16,0,20
2016-02-18 17:50:39.000,"Mike Bostock","Mike Bostock",2,2,4,0,20
2016-02-18 01:37:32.000,"Mike Bostock","Mike Bostock",18,15,33,0,378
2016-02-18 01:36:45.000,"Mike Bostock","Mike Bostock",1,18,19,0,33
2016-02-13 23:07:53.000,"Mike Bostock","Mike Bostock",0,19,19,0,91
2016-02-13 23:06:00.000,"Mike Bostock","Mike Bostock",1,29,30,0,27
2016-02-12 23:11:22.000,"Mike Bostock","Mike Bostock",10,7,17,0,31
2016-02-12 21:51:48.000,"Mike Bostock","Mike Bostock",3,3,6,0,21
2016-02-12 01:50:59.000,"Mike Bostock","Mike Bostock",1,1,2,0,12
2016-02-11 23:07:56.000,"Mike Bostock","Mike Bostock",1,1,2,0,13
2016-02-11 23:02:54.000,"Mike Bostock","Mike Bostock",2,1,3,0,21
2016-02-11 21:05:36.000,"Mike Bostock","Mike Bostock",2,0,2,0,22
2016-02-11 19:45:18.000,"Mike Bostock","Mike Bostock",6,48,54,0,35
2016-02-11 19:43:39.000,"Mike Bostock","Mike Bostock",17,17,34,0,86
2016-02-11 18:34:57.000,"Mike Bostock","Mike Bostock",1,1,2,0,16
2016-02-11 17:41:02.000,"Mike Bostock","Mike Bostock",1,1,2,0,20
2016-02-10 23:08:56.000,"Mike Bostock","Mike Bostock",1,1,2,0,25
2016-02-10 22:48:55.000,"Mike Bostock","Mike Bostock",1,1,2,0,10
2016-02-10 20:10:50.000,"Mike Bostock","Mike Bostock",3,3,6,0,20
2016-02-10 19:17:55.000,"Mike Bostock","Mike Bostock",2,2,4,0,23
2016-02-10 18:34:24.000,"Mike Bostock","Mike Bostock",3,1,4,0,15
2016-02-10 00:01:18.000,"Mike Bostock","Mike Bostock",6,7,13,0,20
2016-02-08 03:47:35.000,"Mike Bostock","Mike Bostock",2,2,4,0,5
2016-02-08 03:46:19.000,"Mike Bostock","Mike Bostock",3,3,6,0,28
2016-02-05 22:24:13.000,"Mike Bostock","Mike Bostock",8,2,10,0,20
2016-02-05 00:28:50.000,"Mike Bostock","Mike Bostock",26,12,38,0,14
2016-02-05 00:22:17.000,"Mike Bostock","Mike Bostock",2,2,4,0,20
2016-02-04 21:30:54.000,"Mike Bostock","Mike Bostock",16,10,26,0,26
2016-02-04 18:04:53.000,"Mike Bostock","Mike Bostock",11,4,15,0,15
2016-02-03 22:06:53.000,"Mike Bostock","Mike Bostock",1,1,2,0,16
2016-02-03 19:27:41.000,"Mike Bostock","Mike Bostock",1,0,1,0,14
2016-02-03 18:51:34.000,"Mike Bostock","Mike Bostock",27,1,28,0,14
2016-02-03 18:03:35.000,"Mike Bostock","Mike Bostock",2,2,4,0,13
2016-02-03 18:03:07.000,"Mike Bostock","Mike Bostock",10,5,15,0,20
2016-02-02 17:40:20.000,"Mike Bostock","Mike Bostock",1,0,1,0,20
2016-02-02 17:10:12.000,"Mike Bostock","Mike Bostock",6,5,11,0,16
2016-02-01 21:58:34.000,"Mike Bostock","Mike Bostock",14,14,28,0,57
2016-02-01 20:30:13.000,"Mike Bostock","Mike Bostock",9,7,16,0,20
2016-01-29 18:51:26.000,"Mike Bostock","Mike Bostock",1,1,2,0,19
2016-01-29 18:50:58.000,"Mike Bostock","Mike Bostock",24,25,49,0,50
2016-01-28 18:53:43.000,"Mike Bostock","Mike Bostock",2,1,3,0,31
2016-01-28 18:50:07.000,"Mike Bostock","Mike Bostock",2,2,4,0,9
2016-01-28 18:49:59.000,"Mike Bostock","Mike Bostock",5,3,8,0,16
2016-01-27 22:51:58.000,"Mike Bostock","Mike Bostock",4,4,8,0,20
2016-01-27 17:30:55.000,"Mike Bostock","Mike Bostock",43,12,55,0,351
2016-01-23 05:11:53.000,"Mike Bostock","Mike Bostock",18,2,20,0,31
2016-01-22 23:56:10.000,"Mike Bostock","Mike Bostock",3,3,6,0,9
2016-01-20 18:34:02.000,"Mike Bostock","Mike Bostock",3,3,6,0,20
2016-01-20 17:55:52.000,"Mike Bostock","Mike Bostock",6,6,12,0,13
2016-01-18 22:57:21.000,"Mike Bostock","Mike Bostock",2,2,4,0,21
2016-01-18 22:55:06.000,"Mike Bostock","Mike Bostock",1,1,2,0,12
2016-01-18 22:52:42.000,"Mike Bostock","Mike Bostock",4,4,8,0,20
2016-01-15 01:33:41.000,"Mike Bostock","Mike Bostock",3,3,6,0,18
2016-01-15 01:19:47.000,"Mike Bostock","Mike Bostock",4,4,8,0,31
2016-01-15 00:18:50.000,"Mike Bostock","Mike Bostock",16,1,17,0,21
2016-01-15 00:06:20.000,"Mike Bostock","Mike Bostock",17,17,34,0,8
2016-01-14 01:11:32.000,"Mike Bostock","Mike Bostock",3,0,3,0,18
2016-01-13 19:55:16.000,"Mike Bostock","Mike Bostock",1,1,2,0,10
2016-01-12 18:39:12.000,"Mike Bostock","Mike Bostock",1,1,2,0,16
2016-01-12 18:31:37.000,"Mike Bostock","Mike Bostock",4,2,6,0,15
2016-01-11 23:37:16.000,"Mike Bostock","Mike Bostock",1,1,2,0,81
2016-01-11 22:27:22.000,"Fernando Lores","Fernando Lores",1,1,2,0,34
2016-01-11 19:22:42.000,"Mike Bostock","Mike Bostock",1,0,1,0,21
2016-01-11 19:21:37.000,"Mike Bostock","Mike Bostock",12,1,13,0,15
2016-01-11 19:16:37.000,"Mike Bostock","Mike Bostock",12,0,12,0,16
2016-01-11 19:12:10.000,"Mike Bostock","Mike Bostock",20,0,20,0,15
2016-01-09 00:03:00.000,"Mike Bostock","Mike Bostock",3,3,6,0,13
2016-01-08 23:28:50.000,"Mike Bostock","Mike Bostock",9,11,20,0,15
2016-01-08 22:08:01.000,"Mike Bostock","Mike Bostock",32,1,33,0,12
2016-01-08 18:34:48.000,"Mike Bostock","Mike Bostock",3,3,6,0,9
2016-01-08 18:33:25.000,"Mike Bostock","Mike Bostock",39,3,42,0,27
2016-01-07 23:51:42.000,"Mike Bostock","Mike Bostock",193,191,384,0,10
2016-01-07 23:38:12.000,"Mike Bostock","Mike Bostock",3,3,6,0,21
2016-01-07 23:37:46.000,"Mike Bostock","Mike Bostock",10,7,17,0,46
2016-01-07 23:28:45.000,"Mike Bostock","Mike Bostock",34,34,68,0,16
2016-01-07 23:06:39.000,"Mike Bostock","Mike Bostock",128,129,257,0,20
2016-01-07 21:10:57.000,"Mike Bostock","Mike Bostock",32,32,64,0,15
2016-01-07 20:55:47.000,"Mike Bostock","Mike Bostock",13,13,26,0,17
2016-01-07 20:42:41.000,"Mike Bostock","Mike Bostock",52,48,100,0,20
2016-01-07 19:58:09.000,"Mike Bostock","Mike Bostock",6,6,12,0,25
2016-01-07 19:57:41.000,"Mike Bostock","Mike Bostock",29,12,41,0,25
2016-01-07 18:50:09.000,"Mike Bostock","Mike Bostock",4,4,8,0,20
2016-01-06 20:50:33.000,"Mike Bostock","Mike Bostock",0,5,5,0,25
2016-01-06 20:50:19.000,"Mike Bostock","Mike Bostock",40,35,75,0,25
2016-01-06 20:39:00.000,"Mike Bostock","Mike Bostock",32,32,64,0,25
2016-01-06 20:32:13.000,"Mike Bostock","Mike Bostock",104,78,182,0,25
2016-01-06 19:25:38.000,"Mike Bostock","Mike Bostock",32,32,64,0,25
2016-01-06 19:20:44.000,"Mike Bostock","Mike Bostock",90,92,182,0,25
2016-01-06 19:01:15.000,"Mike Bostock","Mike Bostock",68,64,132,0,25
2016-01-06 18:50:22.000,"Mike Bostock","Mike Bostock",1,1,2,0,9
2016-01-06 18:45:58.000,"Mike Bostock","Mike Bostock",1,1,2,0,22
2016-01-06 01:27:48.000,"Mike Bostock","Mike Bostock",1,1,2,0,39
2016-01-06 01:19:03.000,"Mike Bostock","Mike Bostock",42,8,50,0,25
2016-01-06 01:00:11.000,"Mike Bostock","Mike Bostock",1,1,2,0,25
2016-01-05 22:53:43.000,"Mike Bostock","Mike Bostock",2,2,4,0,25
2016-01-05 22:53:22.000,"Mike Bostock","Mike Bostock",9,9,18,0,25
2016-01-05 22:52:12.000,"Mike Bostock","Mike Bostock",15,15,30,0,25
2016-01-05 22:41:04.000,"Mike Bostock","Mike Bostock",5,5,10,0,25
2016-01-05 22:39:53.000,"Mike Bostock","Mike Bostock",12,10,22,0,25
2016-01-05 22:34:54.000,"Mike Bostock","Mike Bostock",1,1,2,0,25
2016-01-05 22:34:28.000,"Mike Bostock","Mike Bostock",23,1,24,0,25
2016-01-05 22:26:23.000,"Mike Bostock","Mike Bostock",4,1,5,0,25
2016-01-05 22:25:18.000,"Mike Bostock","Mike Bostock",166,0,166,0,25
2016-01-05 22:06:51.000,"Mike Bostock","Mike Bostock",1,0,1,0,25
2016-01-05 22:05:39.000,"Mike Bostock","Mike Bostock",17,17,34,0,25
2016-01-05 22:04:44.000,"Mike Bostock","Mike Bostock",128,0,128,0,25
2016-01-05 21:50:31.000,"Mike Bostock","Mike Bostock",11,0,11,0,25
2016-01-05 21:47:01.000,"Mike Bostock","Mike Bostock",14,14,28,0,25
2016-01-05 21:45:33.000,"Mike Bostock","Mike Bostock",31,61,92,0,25
2016-01-05 21:42:10.000,"Mike Bostock","Mike Bostock",2,1,3,0,25
2016-01-05 21:41:52.000,"Mike Bostock","Mike Bostock",75,0,75,0,25
2016-01-05 21:28:50.000,"Mike Bostock","Mike Bostock",14,14,28,0,25
2016-01-05 21:28:14.000,"Mike Bostock","Mike Bostock",37,14,51,0,25
2016-01-05 21:19:37.000,"Mike Bostock","Mike Bostock",53,0,53,0,25
2016-01-05 20:52:22.000,"Mike Bostock","Mike Bostock",3,5,8,0,19
2016-01-05 18:29:18.000,"Mike Bostock","Mike Bostock",1,1,2,0,15
2016-01-05 18:20:57.000,"Mike Bostock","Mike Bostock",35,0,35,0,25
2016-01-05 18:13:41.000,"Mike Bostock","Mike Bostock",21,7,28,0,25
2016-01-05 18:08:12.000,"Mike Bostock","Mike Bostock",3,3,6,0,25
2016-01-05 17:54:11.000,"Mike Bostock","Mike Bostock",3,3,6,0,20
2016-01-05 17:50:32.000,"Mike Bostock","Mike Bostock",18,10,28,0,31
2016-01-05 17:12:25.000,"Mike Bostock","Mike Bostock",8,8,16,0,25
2016-01-05 17:12:00.000,"Mike Bostock","Mike Bostock",10,10,20,0,25
2016-01-05 17:11:28.000,"Mike Bostock","Mike Bostock",25,8,33,0,25
2016-01-05 17:05:07.000,"Mike Bostock","Mike Bostock",47,15,62,0,25
2016-01-05 16:55:13.000,"Mike Bostock","Mike Bostock",78,1,79,0,25
2015-09-09 11:38:50.000,"Stef Walter","Stef Walter",7,7,14,0,851
2016-01-05 01:21:58.000,"Mike Bostock","Mike Bostock",1,1,2,0,16
2016-01-05 01:20:06.000,"Mike Bostock","Mike Bostock",2,2,4,0,17
2016-01-05 01:10:00.000,"Mike Bostock","Mike Bostock",14,0,14,0,17
2016-01-05 01:06:04.000,"Mike Bostock","Mike Bostock",30,0,30,0,13
2016-01-05 01:05:54.000,"Mike Bostock","Mike Bostock",7,0,7,0,10
2016-01-05 01:03:16.000,"Mike Bostock","Mike Bostock",58,58,116,0,14
2016-01-02 17:31:18.000,"Mike Bostock","Mike Bostock",1,1,2,0,12
2016-01-02 17:28:32.000,"Mike Bostock","Mike Bostock",137,1,138,0,49
2016-01-02 17:16:22.000,"Mike Bostock","Mike Bostock",23,0,23,0,36
2016-01-02 17:12:35.000,"Mike Bostock","Mike Bostock",94,187,281,0,222
2016-01-02 16:53:17.000,"Mike Bostock","Mike Bostock",1,1,2,0,22
2016-01-02 05:41:20.000,"Mike Bostock","Mike Bostock",373,0,373,2,22
2015-12-17 16:54:34.000,"Mike Bostock","Mike Bostock",18,12,30,0,28
2015-12-14 19:16:41.000,"Mike Bostock","Mike Bostock",52,17,69,0,21
2015-12-14 19:15:13.000,"Mike Bostock","Mike Bostock",3,3,6,0,65
2015-12-14 19:13:30.000,"Mike Bostock","Mike Bostock",44,9,53,0,43
2015-12-11 08:37:17.000,"Sherry Zhou","Sherry Zhou",1,1,2,0,199
2015-11-30 02:39:55.000,"Mike Bostock","Mike Bostock",9,9,18,0,21
2015-11-25 17:02:10.000,"Mike Bostock","Mike Bostock",3,3,6,0,58
2015-11-16 16:02:22.000,"Mike Bostock","Mike Bostock",38,38,76,0,20
2015-11-13 18:25:12.000,"Mike Bostock","Mike Bostock",21,20,41,0,422
2015-11-12 14:04:54.000,"Mike Bostock","Mike Bostock",3,3,6,0,32
2015-11-11 20:25:24.000,"Mike Bostock","Mike Bostock",6,7,13,0,165
2015-11-10 16:34:18.000,"Mike Bostock","Mike Bostock",148,144,292,0,26
2015-11-10 15:56:30.000,"Mike Bostock","Mike Bostock",143,139,282,0,151
2015-11-10 03:57:48.000,"Mike Bostock","Mike Bostock",1080,900,1980,0,20
2015-11-09 16:49:45.000,"Mike Bostock","Mike Bostock",14,16,30,0,216
2015-11-08 22:24:12.000,"Mike Bostock","Mike Bostock",21,5,26,0,31
2015-11-08 22:18:41.000,"Mike Bostock","Mike Bostock",17,3,20,0,130
2015-11-02 18:45:15.000,"Mike Bostock","Mike Bostock",646,646,1292,0,55
2015-11-02 18:23:28.000,"Mike Bostock","Mike Bostock",5,3,8,0,72
2015-10-30 20:46:41.000,"Mike Bostock","Mike Bostock",1,1,2,0,24
2015-10-26 04:08:38.000,"Mike Bostock","Mike Bostock",8,14,22,0,43
2015-10-26 03:46:20.000,"Mike Bostock","Mike Bostock",3,3,6,0,139
2015-10-26 03:21:48.000,"Mike Bostock","Mike Bostock",12,4,16,0,33
2015-10-26 03:18:56.000,"Mike Bostock","Mike Bostock",2,1,3,0,106
2015-10-26 03:10:53.000,"Mike Bostock","Mike Bostock",136,0,136,0,75
2015-10-25 22:29:19.000,"Mike Bostock","Mike Bostock",26,11,37,0,46
2015-10-25 22:11:46.000,"Mike Bostock","Mike Bostock",23,16,39,0,94
2015-10-25 22:04:32.000,"Mike Bostock","Mike Bostock",118,111,229,0,103
2015-10-25 21:42:51.000,"Mike Bostock","Mike Bostock",205,163,368,0,256
2015-10-24 22:23:36.000,"ppeterka","ppeterka",136,0,136,0,22
2015-10-24 16:57:05.000,"Mike Bostock","Mike Bostock",51,13,64,0,34
2015-10-23 21:49:49.000,"Mike Bostock","Mike Bostock",6,3,9,0,42
2015-10-23 19:19:57.000,"Mike Bostock","Mike Bostock",44,34,78,0,44
2015-10-23 05:33:50.000,"Mike Bostock","Mike Bostock",78,61,139,0,40
2015-10-22 22:54:24.000,"Mike Bostock","Mike Bostock",27,18,45,0,44
2015-10-22 22:07:50.000,"Mike Bostock","Mike Bostock",3,3,6,0,8
2015-10-22 22:05:02.000,"Mike Bostock","Mike Bostock",3,3,6,0,60
2015-10-22 21:35:16.000,"Mike Bostock","Mike Bostock",8,18,26,0,72
2015-10-22 21:31:51.000,"Mike Bostock","Mike Bostock",6,1,7,0,46
2015-10-22 21:27:56.000,"Mike Bostock","Mike Bostock",5,1,6,0,75
2015-10-21 19:51:31.000,"Mike Bostock","Mike Bostock",18,18,36,0,24
2015-10-21 19:49:42.000,"Mike Bostock","Mike Bostock",16,0,16,0,17
2015-10-21 19:44:27.000,"Mike Bostock","Mike Bostock",1,1,2,0,1
2015-10-21 19:44:01.000,"Mike Bostock","Mike Bostock",16,0,16,0,70
2015-10-21 18:51:49.000,"Mike Bostock","Mike Bostock",1,1,2,0,24
2015-10-21 18:51:23.000,"Mike Bostock","Mike Bostock",16,0,16,0,79
2015-10-21 18:09:30.000,"Mike Bostock","Mike Bostock",16,0,16,0,79
2015-10-21 17:23:46.000,"Mike Bostock","Mike Bostock",42,6,48,0,416
2015-09-18 15:16:34.000,"Yuichi Yazaki","Yuichi Yazaki",16,0,16,0,22
2015-08-21 18:11:24.000,"leitzler","leitzler",16,0,16,0,66
2015-07-04 04:05:41.000,"Mike Bostock","Mike Bostock",2,3,5,0,8
2015-07-04 04:03:11.000,"Mike Bostock","Mike Bostock",31,56,87,0,20
2015-07-04 03:59:48.000,"Mike Bostock","Mike Bostock",2,3,5,0,57
2015-07-04 03:59:03.000,"Mike Bostock","Mike Bostock",0,32,32,0,26
2015-07-04 03:58:25.000,"Mike Bostock","Mike Bostock",0,1,1,0,67
2015-07-04 03:56:49.000,"Mike Bostock","Mike Bostock",19,8,27,0,70
2015-05-19 15:40:12.000,"Mike Bostock","Mike Bostock",1,6,7,0,70
2015-05-19 11:23:15.000,"Gilad Peleg","Gilad Peleg",1,6,7,0,140
2015-05-13 04:09:35.000,"Chris Rebert","Chris Rebert",0,1,1,1,133
2015-05-06 18:48:09.000,"patriciaborges","patriciaborges",2,1,3,0,39
2015-04-07 06:25:49.000,"Jaemin Jo","Jaemin Jo",1,1,2,0,13
2015-04-07 06:19:54.000,"Jaemin Jo","Jaemin Jo",16,0,16,0,18
2015-04-06 23:28:16.000,"Mike Bostock","Mike Bostock",1,1,2,0,91
2015-04-06 22:49:16.000,"Jonathan Huang","Jonathan Huang",1,1,2,0,16
2015-04-04 10:58:28.000,"Jason Davies","Jason Davies",4,4,8,0,370
2015-04-01 08:58:24.000,"Jason Davies","Jason Davies",19,8,27,0,66
2015-03-31 21:42:15.000,"Nathan Vander Wilt","Nathan Vander Wilt",7,3,10,0,299
2015-03-24 13:54:11.000,"Jason Davies","Jason Davies",3,5,8,0,527
2015-02-13 06:30:56.000,"Jonathan Huang","Jonathan Huang",1,1,2,0,166
2015-02-12 23:17:34.000,"Jonathan Huang","Jonathan Huang",1,1,2,0,497
2015-02-12 23:10:10.000,"Jonathan Huang","Jonathan Huang",1,1,2,0,191
2015-02-12 03:10:24.000,"Mike Bostock","Mike Bostock",1,1,2,0,80
2015-02-11 07:00:17.000,"William Wung","William Wung",1,1,2,0,337
2015-02-10 16:41:56.000,"Mike Bostock","Mike Bostock",1,1,2,0,30
2015-02-10 16:36:27.000,"Mike Bostock","Mike Bostock",5,1,6,0,19
2015-02-10 16:33:30.000,"Mike Bostock","Mike Bostock",95,14,109,0,226
2015-02-08 19:29:34.000,"Mike Bostock","Mike Bostock",1,1,2,0,22
2015-02-08 19:29:21.000,"Mike Bostock","Mike Bostock",1,1,2,0,32
2015-02-08 18:27:47.000,"Mike Bostock","Mike Bostock",5,0,5,0,42
2015-02-08 18:20:33.000,"Mike Bostock","Mike Bostock",1,1,2,0,41
2015-02-08 17:20:49.000,"Mike Bostock","Mike Bostock",40,1,41,0,74
2015-02-08 02:48:24.000,"Mike Bostock","Mike Bostock",5,15,20,1,99
2015-02-07 20:31:21.000,"Mike Bostock","Mike Bostock",327,223,550,0,20
2015-02-07 19:58:56.000,"Mike Bostock","Mike Bostock",6,6,12,0,87
2015-02-07 18:56:17.000,"Mike Bostock","Mike Bostock",0,3,3,0,102
2015-02-07 16:46:43.000,"Mike Bostock","Mike Bostock",16,0,16,0,68
2015-02-07 16:43:36.000,"Mike Bostock","Mike Bostock",16,0,16,0,76
2015-02-07 16:41:44.000,"Mike Bostock","Mike Bostock",23,8,31,0,65
2015-02-07 16:40:09.000,"Mike Bostock","Mike Bostock",12,4,16,0,86
2015-02-07 16:34:36.000,"Mike Bostock","Mike Bostock",1,1,2,0,74
2015-02-07 16:33:21.000,"Mike Bostock","Mike Bostock",5,5,10,0,41
2015-02-07 16:29:07.000,"Mike Bostock","Mike Bostock",20,4,24,0,84
2015-02-07 16:21:51.000,"Mike Bostock","Mike Bostock",3,0,3,0,23
2015-02-07 16:20:24.000,"Mike Bostock","Mike Bostock",3,1,4,0,63
2015-02-07 16:13:36.000,"Mike Bostock","Mike Bostock",1,1,2,0,106
2015-02-07 16:08:10.000,"Mike Bostock","Mike Bostock",3,3,6,0,33
2015-02-07 13:47:33.000,"Jason Davies","Jason Davies",7,7,14,0,227
2015-02-07 06:30:25.000,"Mike Bostock","Mike Bostock",261,201,462,0,629
2015-02-06 00:17:20.000,"Wil Gieseler","Wil Gieseler",8,6,14,0,8
2015-02-06 00:16:33.000,"Wil Gieseler","Wil Gieseler",15,1,16,0,33
2015-02-05 16:34:11.000,"Alex Simoes","Alex Simoes",1,1,2,0,23
2015-01-31 14:47:32.000,"Luca Mussi","Luca Mussi",13,0,13,0,16
2015-01-31 14:16:52.000,"Luca Mussi","Luca Mussi",1,3,4,0,7
2015-01-31 14:15:45.000,"Luca Mussi","Luca Mussi",1,1,2,0,21
2015-01-31 13:42:16.000,"Luca Mussi","Luca Mussi",28,47,75,0,62
2015-01-30 11:15:19.000,"Dan Dascalescu","Dan Dascalescu",1430,471,1901,0,70
2015-01-28 12:18:38.000,"Vlad-Ștefan Harbuz","Vlad-Ștefan Harbuz",7,5,12,0,37
2015-01-15 10:10:52.000,"Arjen van Oostrum","Arjen van Oostrum",4,4,8,0,53
2015-01-14 08:12:48.000,"Arjen van Oostrum","Arjen van Oostrum",16,0,16,0,16
2015-01-13 00:17:08.000,"Jason Davies","Jason Davies",3,1,4,0,40
2014-12-31 00:05:29.000,"Thomas Preusse","Thomas Preusse",12,4,16,0,32
2014-12-30 17:02:12.000,"Mike Bostock","Mike Bostock",53,22,75,0,226
2014-12-22 22:17:18.000,"Mike Bostock","Mike Bostock",27,12,39,0,320
2014-12-19 06:25:49.000,"Dan Dascalescu","Dan Dascalescu",3,4,7,0,37
2014-12-11 10:29:38.000,"mauromelis","mauromelis",16,0,16,0,18
2014-12-09 23:17:44.000,"Chris Rebert","Chris Rebert",0,3,3,0,55
2014-12-09 18:11:40.000,"Mike Bostock","Mike Bostock",38,11,49,0,20
2014-12-09 17:39:27.000,"Mike Bostock","Mike Bostock",8,8,16,0,24
2014-12-08 19:55:47.000,"Mike Bostock","Mike Bostock",32,5,37,0,48
2014-12-08 18:50:38.000,"Mike Bostock","Mike Bostock",189,104,293,0,20
2014-12-08 18:29:02.000,"Mike Bostock","Mike Bostock",179,94,273,0,980
2014-12-08 17:44:25.000,"Mike Bostock","Mike Bostock",6,6,12,0,45
2014-12-06 22:28:55.000,"Mike Bostock","Mike Bostock",1248,430,1678,0,18
2014-12-06 21:54:07.000,"Mike Bostock","Mike Bostock",22,8,30,0,30
2014-12-06 21:47:51.000,"Mike Bostock","Mike Bostock",14,8,22,0,66
2014-12-06 21:31:35.000,"Mike Bostock","Mike Bostock",26,19,45,0,38
2014-12-06 21:26:08.000,"Mike Bostock","Mike Bostock",5,0,5,0,41
2014-12-06 21:21:54.000,"Mike Bostock","Mike Bostock",2,6,8,0,30
2014-12-06 21:21:02.000,"Mike Bostock","Mike Bostock",2,6,8,0,158
2014-12-01 19:42:10.000,"Mike Bostock","Mike Bostock",31,10,41,0,43
2014-11-30 10:05:18.000,"Dan Dascalescu","Dan Dascalescu",8,69,77,0,34
2014-11-29 22:39:59.000,"Dan Dascalescu","Dan Dascalescu",30,81,111,0,41
2014-11-25 07:41:28.000,"Dan Dascalescu","Dan Dascalescu",161,0,161,0,28
2014-11-25 04:08:23.000,"Max Goldstein","Max Goldstein",5,4,9,0,25
2014-11-20 17:58:14.000,"Mike Bostock","Mike Bostock",5,10,15,0,40
2014-11-20 05:48:07.000,"Mike Bostock","Mike Bostock",7,7,14,0,17
2014-11-20 05:39:58.000,"Mike Bostock","Mike Bostock",4,4,8,0,24
2014-11-20 05:38:29.000,"Mike Bostock","Mike Bostock",7,5,12,0,36
2014-11-20 03:30:12.000,"Mike Bostock","Mike Bostock",3,3,6,0,126
2014-11-19 23:19:45.000,"Mike Bostock","Mike Bostock",26,35,61,0,29
2014-11-19 18:31:48.000,"Mike Bostock","Mike Bostock",18,19,37,0,38
2014-11-19 18:25:27.000,"Mike Bostock","Mike Bostock",15,14,29,0,42
2014-11-19 17:57:21.000,"Mike Bostock","Mike Bostock",38,38,76,0,181
2014-11-19 17:41:00.000,"Mike Bostock","Mike Bostock",58,45,103,0,8
2014-11-19 08:04:32.000,"Mike Bostock","Mike Bostock",7,15,22,0,3
2014-11-19 07:50:51.000,"Mike Bostock","Mike Bostock",71,26,97,0,9
2014-11-19 05:32:10.000,"Mike Bostock","Mike Bostock",5,9,14,0,19
2014-11-19 05:28:43.000,"Mike Bostock","Mike Bostock",102,99,201,0,15
2014-11-19 03:54:55.000,"Mike Bostock","Mike Bostock",19,11,30,0,15
2014-11-18 07:02:44.000,"Mike Bostock","Mike Bostock",186,94,280,0,11
2014-11-18 05:48:23.000,"Mike Bostock","Mike Bostock",60,37,97,0,590
2014-11-17 23:43:14.000,"Mike Bostock","Mike Bostock",1,1,2,0,8
2014-11-17 23:21:57.000,"Mike Bostock","Mike Bostock",13,12,25,0,39
2014-11-17 21:59:30.000,"Mike Bostock","Mike Bostock",34,81,115,0,45
2014-11-17 21:53:33.000,"Mike Bostock","Mike Bostock",54,17,71,0,11
2014-11-17 19:30:05.000,"Mike Bostock","Mike Bostock",11,11,22,0,23
2014-11-17 19:01:59.000,"Mike Bostock","Mike Bostock",28,19,47,0,27
2014-11-17 17:03:43.000,"Mike Bostock","Mike Bostock",15,3,18,0,31
2014-11-17 07:49:24.000,"Mike Bostock","Mike Bostock",3,3,6,0,136
2014-11-17 07:47:12.000,"Mike Bostock","Mike Bostock",12,1,13,0,34
2014-11-17 07:40:44.000,"Mike Bostock","Mike Bostock",48,33,81,0,138
2014-11-17 06:09:18.000,"Mike Bostock","Mike Bostock",19,24,43,0,9
2014-11-17 05:58:29.000,"Mike Bostock","Mike Bostock",76,69,145,0,14
2014-11-17 04:46:02.000,"Mike Bostock","Mike Bostock",23,9,32,0,30
2014-11-17 04:39:47.000,"Mike Bostock","Mike Bostock",17,18,35,0,30
2014-11-17 02:58:58.000,"Mike Bostock","Mike Bostock",11,7,18,0,19
2014-11-16 23:28:29.000,"Mike Bostock","Mike Bostock",80,27,107,0,241
2014-11-16 06:50:27.000,"Mike Bostock","Mike Bostock",78,95,173,0,334
2014-11-15 22:35:29.000,"Mike Bostock","Mike Bostock",59,9,68,0,74
2014-11-15 22:19:49.000,"Mike Bostock","Mike Bostock",46,40,86,0,27
2014-11-15 16:57:34.000,"Mike Bostock","Mike Bostock",23,20,43,0,191
2014-11-15 01:59:23.000,"Mike Bostock","Mike Bostock",35,55,90,0,25
2014-11-14 21:31:28.000,"Mike Bostock","Mike Bostock",157,1,158,0,65
2014-11-14 21:12:01.000,"Mike Bostock","Mike Bostock",10,10,20,0,85
2014-11-14 21:04:12.000,"Mike Bostock","Mike Bostock",117,16,133,0,60
2014-11-14 20:55:22.000,"Mike Bostock","Mike Bostock",6,6,12,0,27
2014-11-14 20:54:48.000,"Mike Bostock","Mike Bostock",108,13,121,0,65
2014-11-14 20:54:25.000,"Mike Bostock","Mike Bostock",26,24,50,0,98
2014-11-14 20:53:01.000,"Mike Bostock","Mike Bostock",32,0,32,0,65
2014-11-14 20:52:33.000,"Mike Bostock","Mike Bostock",16,0,16,0,38
2014-11-14 20:52:23.000,"Mike Bostock","Mike Bostock",16,0,16,0,66
2014-11-14 20:52:08.000,"Mike Bostock","Mike Bostock",15,14,29,0,54
2014-11-14 20:51:42.000,"Mike Bostock","Mike Bostock",15,14,29,0,98
2014-11-14 20:51:06.000,"Mike Bostock","Mike Bostock",126,107,233,0,114
2014-11-14 20:50:10.000,"Mike Bostock","Mike Bostock",35,17,52,0,56
2014-11-14 20:49:41.000,"Mike Bostock","Mike Bostock",16,16,32,0,63
2014-11-14 20:45:27.000,"Mike Bostock","Mike Bostock",37,10,47,0,59
2014-11-14 20:44:56.000,"Mike Bostock","Mike Bostock",3,3,6,0,52
2014-11-14 20:44:35.000,"Mike Bostock","Mike Bostock",4,4,8,0,62
2014-11-14 20:44:07.000,"Mike Bostock","Mike Bostock",14,8,22,0,60
2014-11-14 18:53:32.000,"Mike Bostock","Mike Bostock",14,8,22,0,757
2014-11-13 17:30:21.000,"Jason Davies","Jason Davies",2,2,4,0,29
2014-11-13 10:13:24.000,"Jason Davies","Jason Davies",4,4,8,0,473
2014-11-03 22:06:33.000,"Jason Davies","Jason Davies",3,3,6,0,99
2014-10-26 08:52:54.000,"Alon Levy","Alon Levy",7,7,14,0,225
2014-10-24 19:25:41.000,"Mike Bostock","Mike Bostock",37,10,47,0,668
2014-10-23 23:08:17.000,"Mike Bostock","Mike Bostock",3,3,6,0,182
2014-10-18 11:36:03.000,"Jason Davies","Jason Davies",35,17,52,0,514
2014-10-23 18:25:17.000,"Mike Bostock","Mike Bostock",2,2,4,0,104
2014-10-23 18:05:38.000,"Robert Buchholz","Robert Buchholz",2,2,4,0,165
2014-10-23 17:56:09.000,"Mike Bostock","Mike Bostock",126,107,233,0,23
2014-10-22 23:55:54.000,"Dorota","Dorota",1,1,2,0,139
2014-10-22 18:43:21.000,"Mike Bostock","Mike Bostock",946,714,1660,0,42
2014-10-21 14:21:25.000,"Phil Elson","Phil Elson",14,14,28,0,8
2014-10-21 13:43:31.000,"Phil Elson","Phil Elson",1,0,1,0,42
2014-10-17 13:01:43.000,"Jason Davies","Jason Davies",6,6,12,0,13
2014-10-17 07:22:56.000,"Mike Bostock","Mike Bostock",1,5,6,0,19
2014-10-17 07:20:36.000,"Mike Bostock","Mike Bostock",17,17,34,0,26
2014-10-17 07:15:57.000,"Mike Bostock","Mike Bostock",8,10,18,0,29
2014-10-17 07:04:51.000,"Mike Bostock","Mike Bostock",19,17,36,0,38
2014-10-17 07:04:11.000,"Mike Bostock","Mike Bostock",72,24,96,0,37
2014-10-17 07:03:41.000,"Mike Bostock","Mike Bostock",28,25,53,0,48
2014-10-17 07:02:59.000,"Mike Bostock","Mike Bostock",6,4,10,0,38
2014-10-17 07:02:25.000,"Mike Bostock","Mike Bostock",31,3,34,0,50
2014-10-17 07:01:52.000,"Mike Bostock","Mike Bostock",26,16,42,0,40
2014-10-17 07:01:34.000,"Mike Bostock","Mike Bostock",262,260,522,0,38
2014-10-17 07:00:51.000,"Mike Bostock","Mike Bostock",100,25,125,0,42
2014-10-17 07:00:20.000,"Mike Bostock","Mike Bostock",38,99,137,0,40
2014-10-17 06:24:52.000,"Mike Bostock","Mike Bostock",6,4,10,0,47
2014-10-17 06:16:51.000,"Mike Bostock","Mike Bostock",93,158,251,0,175
2014-10-17 06:07:48.000,"Mike Bostock","Mike Bostock",36,133,169,0,190
2014-10-17 05:59:46.000,"Mike Bostock","Mike Bostock",15,18,33,0,93
2014-10-17 05:40:06.000,"Mike Bostock","Mike Bostock",38,99,137,0,27
2014-10-17 05:10:41.000,"Mike Bostock","Mike Bostock",58,20,78,0,102
2014-10-17 00:14:57.000,"Jason Davies","Jason Davies",15,5,20,0,238
2014-10-16 09:40:35.000,"Jason Davies","Jason Davies",29,8,37,0,55
2014-10-16 09:16:02.000,"Jason Davies","Jason Davies",11,5,16,0,53
2014-10-15 18:20:56.000,"Mike Bostock","Mike Bostock",219,75,294,0,51
2014-10-15 17:53:45.000,"Mike Bostock","Mike Bostock",58,101,159,0,33
2014-10-14 18:20:43.000,"Mike Bostock","Mike Bostock",12,15,27,0,18
2014-10-14 18:15:38.000,"Mike Bostock","Mike Bostock",33,0,33,0,28
2014-10-14 18:15:10.000,"Mike Bostock","Mike Bostock",5,5,10,0,22
2014-10-14 18:09:07.000,"Mike Bostock","Mike Bostock",135,54,189,0,470
2014-10-14 02:17:59.000,"John Firebaugh","John Firebaugh",51,19,70,0,363
2014-10-13 22:32:08.000,"Mike Bostock","Mike Bostock",262,260,522,0,265
2014-10-13 21:07:14.000,"Dorota","Dorota",16,0,16,0,24
2014-10-10 19:09:27.000,"Jason Davies","Jason Davies",5,5,10,0,25
2014-10-10 18:59:49.000,"Mike Bostock","Mike Bostock",13,19,32,0,11
2014-10-10 18:31:25.000,"Jason Davies","Jason Davies",3,0,3,0,37
2014-07-29 20:32:58.000,"Dave Landry","Mike Bostock",16,0,16,0,21
2014-07-29 19:05:08.000,"Dave Landry","Mike Bostock",16,0,16,0,25
2014-10-10 18:05:20.000,"Mike Bostock","Mike Bostock",1,1,2,0,19
2014-10-10 18:04:29.000,"Mike Bostock","Mike Bostock",16,0,16,0,68
2014-10-10 18:04:25.000,"Mike Bostock","Mike Bostock",1,1,2,0,19
2014-10-10 18:02:45.000,"Mike Bostock","Mike Bostock",16,0,16,0,68
2014-10-10 17:53:19.000,"Jason Davies","Jason Davies",19,13,32,0,141
2014-10-10 17:46:55.000,"Mike Bostock","Mike Bostock",26,9,35,0,46
2014-10-10 17:35:51.000,"Mike Bostock","Mike Bostock",0,7,7,0,91
2014-10-10 17:21:20.000,"Mike Bostock","Mike Bostock",31,3,34,0,40
2014-10-10 11:01:40.000,"Jason Davies","Jason Davies",6,4,10,0,56
2014-10-10 10:09:57.000,"Jason Davies","Jason Davies",26,26,52,0,1466
2014-08-28 12:16:06.000,"Jason Davies","Jason Davies",71,23,94,0,381
2014-10-09 20:16:04.000,"Mike Bostock","Mike Bostock",8,8,16,0,21
2014-10-09 17:13:04.000,"Mike Bostock","Mike Bostock",7,5,12,0,16
2014-10-09 17:10:51.000,"Mike Bostock","Mike Bostock",19,32,51,0,8
2014-08-07 14:44:56.000,"Jason Davies","Jason Davies",22,9,31,0,521
2014-10-03 21:05:59.000,"Jason Davies","Jason Davies",10,5,15,0,532
2014-10-08 16:45:31.000,"Mike Bostock","Mike Bostock",3,0,3,0,18
2014-10-08 16:09:42.000,"Mike Bostock","Mike Bostock",6,6,12,0,13
2014-10-08 16:04:33.000,"Mike Bostock","Mike Bostock",8,3,11,0,48
2014-10-08 16:03:32.000,"Mike Bostock","Mike Bostock",5,4,9,0,24
2014-10-08 15:58:29.000,"Mike Bostock","Mike Bostock",49,58,107,0,61
2014-10-08 15:49:11.000,"Mike Bostock","Mike Bostock",80,80,160,0,55
2014-10-08 15:47:58.000,"Mike Bostock","Mike Bostock",18,7,25,0,64
2014-10-08 15:46:42.000,"Mike Bostock","Mike Bostock",7,5,12,0,68
2014-10-08 15:45:27.000,"Mike Bostock","Mike Bostock",8,4,12,0,60
2014-10-03 22:05:25.000,"Jason Davies","Jason Davies",8,4,12,0,32
2014-10-02 12:28:44.000,"Yves Le Maout","Yves Le Maout",11,11,22,0,94
2014-09-30 00:01:41.000,"Jason Davies","Jason Davies",7,5,12,0,288
2014-09-28 13:49:31.000,"Thomas Fankhauser","Thomas Fankhauser",28,28,56,0,37
2014-09-27 12:23:03.000,"Thomas Fankhauser","Thomas Fankhauser",21,21,42,0,85
2014-09-27 12:17:03.000,"Thomas Fankhauser","Thomas Fankhauser",44,35,79,0,88
2014-09-10 12:00:54.000,"Jason Davies","Jason Davies",7,3,10,0,59
2014-08-28 17:21:18.000,"Philippe Serhal","Philippe Serhal",16,0,16,0,106
2014-08-28 16:18:56.000,"Philippe Serhal","Philippe Serhal",16,0,16,0,107
2014-08-25 16:55:58.000,"Martin Häcker","Martin Häcker",1,1,2,0,31
2014-08-15 22:34:21.000,"Mike Bostock","Mike Bostock",12,6,18,0,459
2014-08-15 22:32:48.000,"Mike Bostock","Mike Bostock",15,19,34,0,197
2014-08-13 06:50:36.000,"Martin Häcker","Martin Häcker",16,0,16,0,17
2014-08-12 10:47:18.000,"Martin Häcker","Martin Häcker",16,0,16,0,17
2014-08-06 17:32:49.000,"Jason Davies","Jason Davies",80,80,160,0,330
2014-07-18 17:26:37.000,"Jason Davies","Jason Davies",49,58,107,0,18
2014-08-05 19:17:34.000,"Mike Bostock","Mike Bostock",1,0,1,1,19
2014-07-29 14:15:18.000,"Jason Davies","Jason Davies",18,7,25,0,1102
2014-07-17 23:58:17.000,"Mike Bostock","Mike Bostock",18,11,29,0,45
2014-07-17 06:25:23.000,"Mike Bostock","Mike Bostock",4,4,8,0,19
2014-06-19 20:04:05.000,"Mike Bostock","Mike Bostock",8,1,9,0,20
2014-07-12 07:01:16.000,"Mike Bostock","Mike Bostock",23,43,66,0,21
2014-07-12 07:00:28.000,"Mike Bostock","Mike Bostock",6,15,21,0,66
2014-07-12 06:56:49.000,"Mike Bostock","Mike Bostock",12,23,35,0,51
2014-07-12 06:56:12.000,"Mike Bostock","Mike Bostock",1,1,2,0,17
2014-07-12 05:48:40.000,"Mike Bostock","Mike Bostock",16,0,16,0,80
2014-07-07 05:36:25.000,"Mike Bostock","Mike Bostock",12,23,35,0,297
2014-07-01 11:01:40.000,"José Romeu García","José Romeu García",16,0,16,0,24
2014-06-30 18:16:59.000,"Mike Bostock","Mike Bostock",146,155,301,0,20
2014-06-30 18:15:31.000,"Mike Bostock","Mike Bostock",7,0,7,0,38
2014-06-30 18:14:09.000,"Mike Bostock","Mike Bostock",12,3,15,0,33
2014-06-30 18:13:30.000,"Mike Bostock","Mike Bostock",3,3,6,0,40
2014-06-30 18:12:58.000,"Mike Bostock","Mike Bostock",2,2,4,0,33
2014-06-30 18:10:04.000,"Mike Bostock","Mike Bostock",87,144,231,0,42
2014-06-30 11:41:19.000,"Jason Davies","Jason Davies",12,3,15,0,55
2014-06-27 17:19:42.000,"Jason Davies","Jason Davies",39,7,46,0,125
2014-06-25 00:43:37.000,"Mike Bostock","Mike Bostock",87,144,231,0,176
2014-06-24 15:21:49.000,"Tim Branyen","Tim Branyen",2,2,4,0,647
2014-06-08 11:05:34.000,"Jason Davies","Jason Davies",5,7,12,0,138
2014-06-08 04:42:03.000,"Mike Bostock","Mike Bostock",6,10,16,0,17
2014-06-08 00:31:42.000,"Jason Davies","Jason Davies",29,13,42,0,68
2014-06-08 00:17:39.000,"Jason Davies","Jason Davies",43,26,69,0,36
2014-06-06 18:02:08.000,"Mike Bostock","Mike Bostock",79,5,84,0,18
2014-05-30 17:00:01.000,"Mike Bostock","Mike Bostock",108,13,121,0,42
2014-05-28 10:29:56.000,"Philip Jägenstedt","Philip Jägenstedt",1,1,2,0,168
2014-05-23 09:55:35.000,"Thomas Fankhauser","Thomas Fankhauser",5,5,10,0,65
2014-05-22 11:31:22.000,"afc163","afc163",7,0,7,0,15
2014-05-19 19:25:57.000,"Mike Bostock","Mike Bostock",34,17,51,0,36
2014-05-19 19:25:22.000,"Mike Bostock","Mike Bostock",2,6,8,0,12
2014-05-19 18:37:01.000,"Jason Davies","Jason Davies",32,11,43,0,321
2014-05-19 05:42:53.000,"Mike Bostock","Mike Bostock",489,481,970,0,20
2014-05-19 05:41:34.000,"Mike Bostock","Mike Bostock",470,471,941,0,44
2014-05-19 05:40:34.000,"Mike Bostock","Mike Bostock",15,6,21,0,54
2014-05-15 06:49:56.000,"ljani","Mike Bostock",136,0,136,0,18
2014-05-19 04:52:11.000,"Mike Bostock","Mike Bostock",1,1,2,0,96
2014-05-18 23:08:16.000,"Mike Bostock","Mike Bostock",38,74,112,0,27
2014-05-18 16:10:02.000,"Mike Bostock","Mike Bostock",119,116,235,0,30
2014-05-18 06:25:28.000,"Mike Bostock","Mike Bostock",283,291,574,0,31
2014-05-18 06:25:28.000,"Mike Bostock","Mike Bostock",261,232,493,0,26
2014-05-18 04:32:59.000,"Mike Bostock","Mike Bostock",270,259,529,0,347
2014-05-13 22:21:37.000,"Erin Jane","Erin Jane",1,1,2,0,47
2014-05-10 17:25:53.000,"Prajit Ramachandran","Prajit Ramachandran",49,7,56,0,384
2014-04-22 20:13:58.000,"Mike Bostock","Mike Bostock",15,6,21,2,40
2014-04-14 04:55:29.000,"Mike Bostock","Mike Bostock",34,37,71,0,20
2014-04-14 04:54:52.000,"Mike Bostock","Mike Bostock",11,15,26,0,30
2014-04-14 04:54:19.000,"Mike Bostock","Mike Bostock",11,9,20,0,44
2014-04-14 04:53:34.000,"Mike Bostock","Mike Bostock",9,10,19,0,43
2014-04-11 14:02:34.000,"Jason Davies","Jason Davies",11,15,26,0,808
2014-04-11 00:43:16.000,"Mike Bostock","Mike Bostock",11,9,20,0,43
2014-04-10 22:34:40.000,"Jason Davies","Jason Davies",23,23,46,0,28
2014-04-08 16:03:44.000,"Mike Bostock","Mike Bostock",9,10,19,0,43
2014-04-08 05:43:32.000,"Mike Bostock","Mike Bostock",134,147,281,0,20
2014-04-08 05:41:17.000,"Mike Bostock","Mike Bostock",28,15,43,0,66
2014-04-06 06:24:21.000,"Mike Bostock","Mike Bostock",7,17,24,0,30
2014-04-06 06:05:11.000,"Mike Bostock","Mike Bostock",41,0,41,0,35
2014-04-06 05:50:33.000,"Mike Bostock","Mike Bostock",9,8,17,0,187
2014-04-06 05:29:31.000,"Mike Bostock","Mike Bostock",73,131,204,0,27
2014-04-04 14:29:23.000,"Jason Davies","Jason Davies",29,16,45,0,192
2014-03-25 03:45:44.000,"Mike Bostock","Mike Bostock",518,304,822,0,20
2014-03-24 16:02:48.000,"Mike Bostock","Mike Bostock",5,5,10,0,209
2014-03-24 05:57:35.000,"Mike Bostock","Mike Bostock",27,33,60,0,17
2014-03-24 05:46:33.000,"Mike Bostock","Mike Bostock",12,3,15,0,56
2014-03-24 05:42:28.000,"Mike Bostock","Mike Bostock",5,1,6,0,61
2014-03-24 05:37:49.000,"Mike Bostock","Mike Bostock",8,6,14,0,96
2014-03-24 05:29:17.000,"Mike Bostock","Mike Bostock",11,10,21,0,269
2014-03-24 05:09:53.000,"Mike Bostock","Mike Bostock",42,37,79,0,422
2014-03-24 04:37:34.000,"Mike Bostock","Mike Bostock",52,11,63,0,277
2014-03-23 21:37:40.000,"Mike Bostock","Mike Bostock",5,3,8,0,80
2014-03-23 21:10:55.000,"Mike Bostock","Mike Bostock",98,98,196,0,279
2014-02-27 22:48:48.000,"Mike Bostock","Mike Bostock",23,25,48,0,142
2014-02-04 19:50:09.000,"Darrick Brown","Mike Bostock",12,12,24,0,116
2013-07-09 22:15:23.000,"Timmy Willison","Mike Bostock",3,5,8,0,34
2013-07-09 20:17:31.000,"Timmy Willison","Mike Bostock",7,7,14,0,39
2014-03-23 00:17:04.000,"Mike Bostock","Mike Bostock",10,3,13,0,248
2014-03-20 18:31:20.000,"Mike Bostock","Mike Bostock",7,39,46,0,115
2014-03-19 21:42:12.000,"Mike Bostock","Mike Bostock",17,13,30,0,253
2014-03-19 21:00:58.000,"Mike Bostock","Mike Bostock",100,63,163,0,397
2014-03-19 16:58:41.000,"Mike Bostock","Mike Bostock",3,1,4,0,449
2014-03-17 04:05:12.000,"Mike Bostock","Mike Bostock",8,7,15,0,177
2014-03-07 04:17:03.000,"Mike Bostock","Mike Bostock",14,14,28,0,213
2014-03-06 17:58:37.000,"Mike Bostock","Mike Bostock",173,32,205,0,707
2014-03-24 03:24:32.000,"Mike Bostock","Mike Bostock",136,0,136,0,82
2014-03-22 14:35:26.000,"Mike Bostock","Mike Bostock",12,12,24,0,116
2014-03-22 04:50:22.000,"Jim Kang","Jim Kang",12,12,24,0,203
2014-03-21 21:04:36.000,"Roger Bramon","Roger Bramon",136,0,136,0,26
2014-03-20 14:24:57.000,"Jason Davies","Jason Davies",2,2,4,0,41
2014-03-20 14:20:55.000,"Jason Davies","Jason Davies",17,1,18,0,86
2014-03-17 15:10:35.000,"Mike Bostock","Mike Bostock",136,0,136,0,77
2014-03-17 13:11:34.000,"Fabricio Tavares de Oliveira","Fabricio Tavares de Oliveira",136,0,136,0,95
2014-03-13 15:07:42.000,"Mike Bostock","Mike Bostock",16,0,16,0,73
2014-03-13 13:30:06.000,"Alexander WU","Alexander WU",16,0,16,0,26
2014-03-09 18:14:50.000,"Mike Bostock","Mike Bostock",1,1,2,0,33
2014-02-27 15:50:18.000,"Mike Bostock","Mike Bostock",21,17,38,0,23
2014-02-27 00:22:40.000,"Jason Davies","Jason Davies",16,12,28,0,513
2014-02-18 16:39:33.000,"Mike Bostock","Mike Bostock",38,11,49,0,25
2014-02-18 16:38:48.000,"Mike Bostock","Mike Bostock",29,9,38,1,32
2014-02-18 16:19:56.000,"Mike Bostock","Mike Bostock",9,2,11,0,65
2014-02-18 16:14:25.000,"Mike Bostock","Mike Bostock",1,1,2,0,68
2014-02-12 02:29:15.000,"jbblanchet","jbblanchet",5,0,5,0,34
2014-02-11 19:33:51.000,"jbblanchet","jbblanchet",4,2,6,0,100
2014-02-03 10:04:15.000,"PatrickJS","PatrickJS",1,1,2,0,21
2014-01-21 16:10:09.000,"Mike Bostock","Mike Bostock",1,0,1,0,59
2014-01-21 02:51:51.000,"Jesus Magana","Jesus Magana",1,0,1,0,9
2014-01-16 17:57:14.000,"Mike Bostock","Mike Bostock",19,0,19,0,82
2014-01-15 22:34:25.000,"Mike Bostock","Mike Bostock",1,1,2,0,25
2014-01-15 07:14:28.000,"kmindi","kmindi",1,1,2,0,39
2014-01-14 23:15:26.000,"kmindi","kmindi",1,2,3,0,44
2014-01-14 23:02:33.000,"kmindi","kmindi",20,0,20,0,35
2014-01-13 19:39:15.000,"Mike Bostock","Mike Bostock",32,44,76,0,112
2014-01-10 22:18:17.000,"Jason Davies","Jason Davies",1,1,2,0,25
2014-01-10 17:52:03.000,"Mike Bostock","Mike Bostock",4,4,8,1,41
2014-01-10 05:40:47.000,"Mike Bostock","Mike Bostock",9,10,19,0,30
2014-01-10 00:44:43.000,"Mike Bostock","Mike Bostock",3,3,6,0,40
2014-01-10 00:43:32.000,"Mike Bostock","Mike Bostock",164,56,220,0,30
2014-01-10 00:38:12.000,"Mike Bostock","Mike Bostock",10,5,15,0,30
2014-01-10 00:37:18.000,"Mike Bostock","Mike Bostock",10,5,15,0,156
2014-01-09 23:36:18.000,"Mike Bostock","Mike Bostock",6,6,12,0,20
2014-01-09 23:33:53.000,"Mike Bostock","Mike Bostock",45,27,72,0,45
2014-01-09 23:33:19.000,"Mike Bostock","Mike Bostock",6982,6924,13906,0,30
2014-01-09 23:32:48.000,"Mike Bostock","Mike Bostock",226,97,323,0,38
2014-01-09 23:32:10.000,"Mike Bostock","Mike Bostock",43,28,71,0,30
2014-01-09 23:31:05.000,"Mike Bostock","Mike Bostock",135,175,310,0,73
2014-01-09 23:25:16.000,"Mike Bostock","Mike Bostock",37,50,87,0,32
2014-01-09 23:14:25.000,"Mike Bostock","Mike Bostock",127,20,147,0,82
2014-01-09 22:03:03.000,"Mike Bostock","Mike Bostock",3,1,4,0,19
2014-01-09 21:54:49.000,"Mike Bostock","Mike Bostock",41,28,69,2,327
2014-01-09 19:07:32.000,"Mike Bostock","Mike Bostock",132,1,133,0,24
2014-01-09 18:50:11.000,"Mike Bostock","Mike Bostock",32,55,87,0,150
2014-01-08 23:47:10.000,"Mike Bostock","Mike Bostock",26,0,26,0,30
2014-01-08 23:30:21.000,"Mike Bostock","Mike Bostock",74,66,140,0,226
2014-01-08 23:00:32.000,"Mike Bostock","Mike Bostock",113,120,233,0,320
2014-01-08 22:45:44.000,"Mike Bostock","Mike Bostock",16,0,16,0,33
2014-01-08 22:29:44.000,"Mike Bostock","Mike Bostock",14,13,27,0,12
2014-01-08 22:21:24.000,"Mike Bostock","Mike Bostock",775,774,1549,0,30
2013-11-29 17:09:51.000,"Mike Bostock","Mike Bostock",1095,1082,2177,0,764
2014-01-08 21:04:12.000,"Mike Bostock","Mike Bostock",72,87,159,0,27
2013-12-03 17:01:41.000,"Mike Bostock","Mike Bostock",3,3,6,0,9
2013-12-03 16:59:45.000,"Mike Bostock","Mike Bostock",78,26,104,0,102
2013-12-03 16:50:06.000,"Mike Bostock","Mike Bostock",117,25,142,0,46
2013-12-16 17:24:53.000,"Mike Bostock","Mike Bostock",19,9,28,0,43
2013-12-16 17:22:34.000,"Mike Bostock","Mike Bostock",7,8,15,0,16
2013-12-16 01:06:57.000,"Stuart Glaser","Stuart Glaser",6,0,6,0,43
2013-12-16 00:55:59.000,"Stuart Glaser","Stuart Glaser",5,0,5,0,50
2013-12-14 00:06:11.000,"Mike Bostock","Mike Bostock",77,31,108,0,21
2013-12-14 00:04:00.000,"Mike Bostock","Mike Bostock",35,20,55,0,37
2013-12-14 00:03:09.000,"Mike Bostock","Mike Bostock",28,9,37,0,38
2013-12-13 23:59:50.000,"Mike Bostock","Mike Bostock",16,4,20,0,32
2013-12-13 23:57:10.000,"Mike Bostock","Mike Bostock",28,9,37,0,112
2013-12-13 22:00:23.000,"Mike Bostock","Mike Bostock",47,59,106,0,189
2013-12-12 23:36:35.000,"Mike Bostock","Mike Bostock",42,37,79,0,43
2013-12-05 16:18:23.000,"Mike Bostock","Mike Bostock",3,3,6,0,139
2013-12-05 08:05:38.000,"Daniel Goldbach","Daniel Goldbach",3,3,6,0,70
2013-12-04 18:00:18.000,"Mike Bostock","Mike Bostock",16,4,20,0,234
2013-12-04 13:41:34.000,"Daniel Goldbach","Daniel Goldbach",1,1,2,0,22
2013-12-04 13:40:56.000,"Daniel Goldbach","Daniel Goldbach",49,42,91,0,52
2013-12-04 13:03:12.000,"Daniel Goldbach","Daniel Goldbach",21,17,38,0,358
2013-12-03 20:04:03.000,"Mike Bostock","Mike Bostock",54,32,86,0,47
2013-12-03 16:23:14.000,"Mike Bostock","Mike Bostock",8,1,9,0,81
2013-11-30 01:04:42.000,"Mike Bostock","Mike Bostock",11,11,22,0,344
2013-11-25 12:26:45.000,"Guy Bedford","Guy Bedford",8,1,9,0,31
2013-11-24 02:49:32.000,"Daniel Goldbach","Daniel Goldbach",15,16,31,0,40
2013-11-24 02:14:12.000,"Daniel Goldbach","Daniel Goldbach",6,6,12,0,29
2013-11-24 02:03:07.000,"Daniel Goldbach","Daniel Goldbach",9,2,11,0,13
2013-11-24 02:02:42.000,"Daniel Goldbach","Daniel Goldbach",16,8,24,0,35
2013-11-23 13:01:13.000,"Daniel Goldbach","Daniel Goldbach",0,2,2,0,25
2013-11-23 11:15:04.000,"Daniel Goldbach","Daniel Goldbach",0,2,2,0,52
2013-11-23 11:13:05.000,"Daniel Goldbach","Daniel Goldbach",2,0,2,0,58
2013-11-23 11:11:59.000,"Daniel Goldbach","Daniel Goldbach",7,7,14,0,51
2013-11-23 11:04:37.000,"Daniel Goldbach","Daniel Goldbach",18,0,18,0,40
2013-11-23 10:51:33.000,"Daniel Goldbach","Daniel Goldbach",41,33,74,0,62
2013-11-23 09:29:50.000,"Daniel Goldbach","Daniel Goldbach",29,71,100,0,18
2013-11-23 09:15:16.000,"Daniel Goldbach","Daniel Goldbach",7,6,13,0,41
2013-11-23 09:11:35.000,"Daniel Goldbach","Daniel Goldbach",147,11,158,0,49
2013-11-20 23:25:24.000,"Mike Bostock","Mike Bostock",1,1,2,2,16
2013-11-20 20:59:08.000,"Mike Bostock","Mike Bostock",2,0,2,0,16
2013-11-19 17:19:00.000,"Mike Bostock","Mike Bostock",36,37,73,0,21
2013-11-19 17:18:12.000,"Mike Bostock","Mike Bostock",6,6,12,0,45
2013-11-19 17:17:26.000,"Mike Bostock","Mike Bostock",4,4,8,0,47
2013-11-19 17:17:11.000,"Mike Bostock","Mike Bostock",6,6,12,0,79
2013-11-17 17:11:37.000,"Mike Bostock","Mike Bostock",4,4,8,0,421
2013-11-19 17:12:09.000,"Mike Bostock","Mike Bostock",22,34,56,0,53
2013-11-09 09:53:19.000,"Jason Davies","Mike Bostock",22,11,33,0,295
2013-11-19 16:37:28.000,"Mike Bostock","Mike Bostock",7,0,7,0,55
2013-11-19 02:55:37.000,"Daniel Goldbach","Daniel Goldbach",25,0,25,0,39
2013-11-19 02:54:32.000,"Daniel Goldbach","Daniel Goldbach",27,72,99,0,18
2013-11-19 02:54:16.000,"Daniel Goldbach","Daniel Goldbach",5,4,9,0,29
2013-11-19 02:47:48.000,"Daniel Goldbach","Daniel Goldbach",6,0,6,0,20
2013-11-19 02:40:46.000,"Daniel Goldbach","Daniel Goldbach",4,2,6,0,13
2013-11-19 02:39:57.000,"Daniel Goldbach","Daniel Goldbach",3,5,8,0,24
2013-11-18 22:08:13.000,"Mike Bostock","Mike Bostock",25,0,25,0,17
2013-11-18 15:56:17.000,"Daniel Goldbach","Daniel Goldbach",0,0,0,0,76
2013-11-18 15:35:29.000,"Daniel Goldbach","Daniel Goldbach",49,80,129,0,57
2013-11-18 15:35:29.000,"Daniel Goldbach","Daniel Goldbach",49,80,129,0,23
2013-11-18 15:35:44.000,"Daniel Goldbach","Daniel Goldbach",5,5,10,0,12
2013-11-15 10:43:23.000,"Guy Bedford","Guy Bedford",5,0,5,0,28
2013-11-11 21:06:20.000,"Mike Bostock","Mike Bostock",2,2,4,0,26
2013-11-04 20:03:23.000,"Nathan Vander Wilt","Nathan Vander Wilt",4,4,8,0,18
2013-11-04 19:41:48.000,"Nathan Vander Wilt","Nathan Vander Wilt",2,2,4,0,91
2013-10-25 23:36:50.000,"Mike Bostock","Mike Bostock",188,84,272,0,20
2013-10-25 23:35:59.000,"Mike Bostock","Mike Bostock",20,15,35,0,74
2013-10-25 23:35:22.000,"Mike Bostock","Mike Bostock",64,11,75,0,74
2013-10-25 22:53:47.000,"Mike Bostock","Mike Bostock",20,15,35,1,272
2013-10-17 17:11:22.000,"Mike Bostock","Mike Bostock",45,29,74,0,14
2013-10-17 16:58:19.000,"Mike Bostock","Mike Bostock",41,4,45,0,86
2013-10-17 01:32:04.000,"Harry Voorhees","Harry Voorhees",9,5,14,0,69
2013-10-17 01:12:08.000,"Harry Voorhees","Harry Voorhees",15,18,33,0,110
2013-10-17 00:10:20.000,"Harry Voorhees","Harry Voorhees",25,21,46,0,92
2013-10-16 17:13:43.000,"Mike Bostock","Mike Bostock",84,84,168,0,313
2013-10-16 16:47:09.000,"Mike Bostock","Mike Bostock",73,55,128,0,28
2013-10-15 22:43:09.000,"Jason Davies","Jason Davies",63,35,98,0,277
2013-10-14 16:56:31.000,"Mike Bostock","Mike Bostock",357,322,679,0,20
2013-10-14 16:55:15.000,"Mike Bostock","Mike Bostock",21,11,32,0,67
2013-10-14 16:54:43.000,"Mike Bostock","Mike Bostock",306,289,595,0,62
2013-10-12 05:24:28.000,"Mike Bostock","Mike Bostock",7,2,9,0,41
2013-10-12 05:21:26.000,"Mike Bostock","Mike Bostock",5,7,12,0,19
2013-10-12 05:06:01.000,"Mike Bostock","Mike Bostock",10,4,14,0,28
2013-10-11 19:40:10.000,"Mike Bostock","Mike Bostock",18,16,34,0,216
2013-10-11 16:11:04.000,"Jason Davies","Jason Davies",299,287,586,0,119
2013-10-11 11:41:55.000,"Jason Davies","Jason Davies",17,5,22,0,317
2013-10-11 04:53:19.000,"Mike Bostock","Mike Bostock",2,2,4,0,42
2013-10-11 04:51:20.000,"Mike Bostock","Mike Bostock",10,0,10,0,36
2013-10-11 04:49:09.000,"Mike Bostock","Mike Bostock",11,3186,3197,0,50
2013-10-11 01:19:13.000,"Mike Bostock","Mike Bostock",184,256,440,0,226
2013-10-11 00:46:19.000,"Mike Bostock","Mike Bostock",2175,1443,3618,0,20
2013-10-10 16:44:29.000,"Mike Bostock","Mike Bostock",30,29,59,0,20
2013-10-10 16:36:59.000,"Mike Bostock","Mike Bostock",60,60,120,0,20
2013-10-10 16:26:30.000,"Mike Bostock","Mike Bostock",26,27,53,0,19
2013-10-10 06:11:07.000,"Mike Bostock","Mike Bostock",5,7,12,0,20
2013-10-10 05:22:44.000,"Mike Bostock","Mike Bostock",3,3,6,0,283
2013-10-10 00:53:12.000,"Mike Bostock","Mike Bostock",7,12,19,0,8
2013-10-10 00:46:23.000,"Mike Bostock","Mike Bostock",25,27,52,0,344
2013-10-09 22:43:35.000,"Mike Bostock","Mike Bostock",43,32,75,0,106
2013-10-09 20:30:28.000,"Harry Voorhees","Harry Voorhees",24,4,28,0,64
2013-10-09 17:09:48.000,"Harry Voorhees","Harry Voorhees",10,0,10,0,101
2013-10-09 17:07:16.000,"Mike Bostock","Mike Bostock",19,16,35,0,17
2013-10-09 16:43:03.000,"Mike Bostock","Mike Bostock",4,3,7,0,17
2013-10-09 16:37:37.000,"Mike Bostock","Mike Bostock",55,11,66,0,226
2013-10-09 16:13:22.000,"Mike Bostock","Mike Bostock",24,16,40,0,25
2013-10-09 16:10:05.000,"Mike Bostock","Mike Bostock",6,6,12,0,13
2013-10-09 16:09:35.000,"Mike Bostock","Mike Bostock",9,9,18,0,67
2013-10-09 16:09:07.000,"Mike Bostock","Mike Bostock",3,3,6,0,70
2013-10-09 16:08:27.000,"Mike Bostock","Mike Bostock",17,24,41,0,52
2013-10-09 16:07:55.000,"Mike Bostock","Mike Bostock",291,223,514,0,100
2013-10-09 15:57:55.000,"Mike Bostock","Mike Bostock",6,6,12,0,183
2013-10-09 15:42:04.000,"Harry Voorhees","Harry Voorhees",2,0,2,0,69
2013-10-07 23:27:41.000,"Mike Bostock","Mike Bostock",3,3,6,0,45
2013-10-07 17:06:01.000,"Mike Bostock","Mike Bostock",6,9,15,0,9
2013-10-07 17:00:34.000,"Mike Bostock","Mike Bostock",65,66,131,0,9
2013-10-05 23:26:47.000,"Jason Davies","Jason Davies",9,9,18,0,251
2013-10-05 22:59:03.000,"Mike Bostock","Mike Bostock",18,6,24,0,37
2013-10-05 22:39:31.000,"Mike Bostock","Mike Bostock",4,4,8,0,25
2013-10-05 21:50:13.000,"Jason Davies","Mike Bostock",3,3,6,0,18
2013-10-05 21:47:23.000,"Jason Davies","Mike Bostock",5,11,16,0,9
2013-10-05 21:43:38.000,"Jason Davies","Mike Bostock",3,7,10,0,148
2013-10-05 21:28:15.000,"Mike Bostock","Mike Bostock",3,3,6,0,27
2013-10-05 21:17:21.000,"Jason Davies","Mike Bostock",7,3,10,0,28
2013-10-05 21:05:13.000,"Jason Davies","Mike Bostock",15,9,24,0,165
2013-10-05 19:15:43.000,"Mike Bostock","Mike Bostock",50,7,57,0,27
2013-10-03 05:04:00.000,"Mike Bostock","Mike Bostock",45,27,72,0,22
2013-09-24 21:58:32.000,"Mike Bostock","Mike Bostock",215,153,368,0,73
2013-09-24 21:22:13.000,"Mike Bostock","Mike Bostock",24,0,24,0,22
2013-09-24 19:10:09.000,"Mike Bostock","Mike Bostock",5,5,10,0,8
2013-09-24 19:07:51.000,"Mike Bostock","Mike Bostock",13,18,31,0,8
2013-09-24 19:05:14.000,"Mike Bostock","Mike Bostock",20,16,36,0,8
2013-09-24 19:01:53.000,"Mike Bostock","Mike Bostock",10,27,37,0,8
2013-09-24 18:58:59.000,"Mike Bostock","Mike Bostock",11,14,25,0,8
2013-09-24 18:51:24.000,"Mike Bostock","Mike Bostock",6,6,12,0,8
2013-09-23 19:36:37.000,"Mike Bostock","Mike Bostock",3,3,6,0,41
2013-09-23 17:54:09.000,"Mike Bostock","Mike Bostock",11,11,22,0,38
2013-09-23 17:47:45.000,"Mike Bostock","Mike Bostock",60,59,119,0,42
2013-09-23 17:40:07.000,"Mike Bostock","Mike Bostock",3,3,6,0,17
2013-09-23 17:02:20.000,"Mike Bostock","Mike Bostock",119,177,296,0,50
2013-09-23 09:02:21.000,"Mike Bostock","Mike Bostock",15,22,37,0,17
2013-09-23 08:50:06.000,"Mike Bostock","Mike Bostock",3,5,8,0,8
2013-09-23 08:30:13.000,"Mike Bostock","Mike Bostock",15,15,30,0,12
2013-09-23 08:27:02.000,"Mike Bostock","Mike Bostock",91,86,177,0,42
2013-09-23 08:06:38.000,"Mike Bostock","Mike Bostock",5,9,14,0,8
2013-09-23 07:56:37.000,"Mike Bostock","Mike Bostock",3,3,6,0,31
2013-09-23 07:56:20.000,"Mike Bostock","Mike Bostock",0,27,27,0,24
2013-09-23 07:53:49.000,"Mike Bostock","Mike Bostock",103,95,198,0,15
2013-09-23 07:48:56.000,"Mike Bostock","Mike Bostock",16,16,32,0,14
2013-09-23 07:46:25.000,"Mike Bostock","Mike Bostock",34,34,68,0,14
2013-09-23 07:39:45.000,"Mike Bostock","Mike Bostock",84,90,174,0,31
2013-09-23 07:36:31.000,"Mike Bostock","Mike Bostock",57,58,115,0,16
2013-09-23 07:32:42.000,"Mike Bostock","Mike Bostock",10,10,20,0,14
2013-09-23 07:30:08.000,"Mike Bostock","Mike Bostock",343,343,686,0,19
2013-09-23 07:24:52.000,"Mike Bostock","Mike Bostock",447,449,896,0,19
2013-09-23 06:46:04.000,"Mike Bostock","Mike Bostock",61,61,122,0,21
2013-09-23 06:43:11.000,"Mike Bostock","Mike Bostock",129,147,276,0,39
2013-09-23 06:29:39.000,"Mike Bostock","Mike Bostock",30,40,70,0,13
2013-09-23 06:22:20.000,"Mike Bostock","Mike Bostock",1321,2248,3569,0,47
2013-09-23 01:15:14.000,"Mike Bostock","Mike Bostock",971,959,1930,0,188
2013-09-22 17:58:03.000,"Mike Bostock","Mike Bostock",1515,0,1515,0,22
2013-10-05 18:31:24.000,"Mike Bostock","Mike Bostock",16,23,39,0,61
2013-10-03 21:08:48.000,"Jason Davies","Jason Davies",5,5,10,0,9
2013-10-03 19:34:18.000,"Jason Davies","Jason Davies",53,61,114,0,9
2013-10-03 17:20:44.000,"Jason Davies","Jason Davies",10,9,19,0,25
2013-10-03 15:46:22.000,"Jason Davies","Jason Davies",259,184,443,1,418
2013-09-26 22:38:51.000,"Mike Bostock","Mike Bostock",241,197,438,0,20
2013-09-26 22:38:01.000,"Mike Bostock","Mike Bostock",6,6,12,11,20
2013-09-26 22:26:06.000,"Mike Bostock","Mike Bostock",9,9,18,0,78
2013-09-26 22:08:16.000,"Mike Bostock","Mike Bostock",30,35,65,0,250
2013-09-26 15:52:02.000,"Jason Davies","Jason Davies",34,39,73,0,1309
2013-09-25 20:53:21.000,"Mike Bostock","Mike Bostock",76,26,102,0,64
2013-09-25 20:00:50.000,"Mike Bostock","Mike Bostock",7,7,14,0,102
2013-09-25 19:44:50.000,"Mike Bostock","Mike Bostock",2,3,5,0,15
2013-09-25 19:43:53.000,"Mike Bostock","Mike Bostock",53,49,102,1,6
2013-09-25 19:39:46.000,"Mike Bostock","Mike Bostock",3,5,8,1,12
2013-09-25 19:24:28.000,"Jason Davies","Jason Davies",17,31,48,0,9
2013-09-25 19:15:32.000,"Jason Davies","Jason Davies",21,24,45,0,35
2013-09-25 05:31:08.000,"Mike Bostock","Mike Bostock",3,3,6,0,174
2013-09-25 05:21:10.000,"Mike Bostock","Mike Bostock",7,7,14,0,9
2013-09-24 20:03:05.000,"Jason Davies","Jason Davies",56,36,92,0,609
2013-09-24 20:08:33.000,"Jason Davies","Jason Davies",23,19,42,0,9
2013-09-24 18:49:46.000,"Jason Davies","Jason Davies",74,28,102,0,349
2013-09-21 19:49:09.000,"Mike Bostock","Mike Bostock",66,33,99,0,42
2013-09-21 18:31:07.000,"Mike Bostock","Mike Bostock",61,28,89,0,664
2013-09-19 04:52:44.000,"Mike Bostock","Mike Bostock",66,36,102,0,20
2013-09-19 04:51:35.000,"Mike Bostock","Mike Bostock",11,3,14,0,74
2013-09-19 04:50:30.000,"Mike Bostock","Mike Bostock",5,5,10,0,66
2013-09-19 04:50:12.000,"Mike Bostock","Mike Bostock",44,19,63,0,60
2013-09-19 04:35:27.000,"Mike Bostock","Mike Bostock",11,3,14,0,186
2013-09-19 04:06:37.000,"Mike Bostock","Mike Bostock",5,5,10,6,579
2013-09-16 22:30:20.000,"Jason Davies","Jason Davies",44,19,63,0,757
2013-09-05 21:31:03.000,"Jason Davies","Jason Davies",1,4,5,0,255
2013-09-05 19:53:01.000,"Jason Davies","Jason Davies",3,3,6,0,45
2013-09-05 19:21:15.000,"Mike Bostock","Mike Bostock",133,85,218,0,20
2013-09-05 19:20:40.000,"Mike Bostock","Mike Bostock",77,44,121,0,39
2013-09-05 19:20:07.000,"Mike Bostock","Mike Bostock",46,14,60,0,41
2013-09-05 18:52:56.000,"Mike Bostock","Mike Bostock",5,14,19,0,154
2013-09-05 18:31:39.000,"Mike Bostock","Mike Bostock",7,15,22,0,398
2013-09-05 06:37:25.000,"Mike Bostock","Mike Bostock",13,6,19,0,19
2013-08-31 16:34:03.000,"Jason Davies","Jason Davies",3,3,6,0,79
2013-08-31 15:10:00.000,"Jason Davies","Jason Davies",20,13,33,1,274
2013-08-31 11:10:10.000,"Jason Davies","Jason Davies",6,6,12,0,23
2013-08-31 01:29:59.000,"Jason Davies","Jason Davies",9,9,18,0,181
2013-08-31 01:09:24.000,"Jason Davies","Jason Davies",4,11,15,0,294
2013-08-31 00:30:26.000,"Jason Davies","Jason Davies",13,5,18,1,220
2013-08-30 23:10:48.000,"Jason Davies","Jason Davies",48,23,71,0,326
2013-08-28 10:01:22.000,"Jason Davies","Jason Davies",39,14,53,0,172
2013-08-27 06:39:58.000,"Mike Bostock","Mike Bostock",39,39,78,3,383
2013-08-23 22:18:53.000,"Mike Bostock","Mike Bostock",6,6,12,0,13
2013-08-23 22:17:53.000,"Mike Bostock","Mike Bostock",11,7,18,0,69
2013-08-23 22:17:12.000,"Mike Bostock","Mike Bostock",11,4,15,0,67
2013-08-23 22:15:30.000,"Mike Bostock","Mike Bostock",4,4,8,0,106
2013-08-23 21:09:32.000,"Jason Davies","Jason Davies",4,4,8,0,9
2013-08-23 19:59:42.000,"Jason Davies","Jason Davies",1,1,2,0,14
2013-08-23 18:51:59.000,"Jason Davies","Jason Davies",12,5,17,0,46
2013-08-23 00:49:57.000,"Mike Bostock","Mike Bostock",28,27,55,0,28
2013-08-22 23:55:57.000,"Mike Bostock","Mike Bostock",39,22,61,0,22
2013-08-22 09:19:41.000,"Jason Davies","Jason Davies",7,3,10,0,206
2013-08-22 05:08:52.000,"Mike Bostock","Mike Bostock",6,6,12,0,14
2013-08-22 05:05:22.000,"Mike Bostock","Mike Bostock",3,3,6,0,36
2013-08-22 04:59:43.000,"Mike Bostock","Mike Bostock",138,21,159,0,59
2013-08-21 20:16:21.000,"Mike Bostock","Mike Bostock",8,8,16,0,19
2013-08-21 20:08:37.000,"Mike Bostock","Mike Bostock",203,199,402,0,31
2013-08-21 19:57:51.000,"Mike Bostock","Mike Bostock",6,10,16,0,18
2013-08-21 19:47:41.000,"Mike Bostock","Mike Bostock",65,95,160,0,45
2013-08-19 19:13:10.000,"Mike Bostock","Mike Bostock",9,9,18,0,19
2013-08-19 19:06:53.000,"Mike Bostock","Mike Bostock",43,5,48,0,13
2013-08-19 18:50:09.000,"Mike Bostock","Mike Bostock",188,118,306,0,267
2013-08-16 23:13:31.000,"Mike Bostock","Mike Bostock",85,135,220,0,50
2013-08-16 19:34:51.000,"Mike Bostock","Mike Bostock",15,14,29,0,333
2013-08-16 18:25:07.000,"Mike Bostock","Mike Bostock",108,112,220,0,554
2013-08-15 22:55:40.000,"Mike Bostock","Mike Bostock",97,82,179,1,229
2013-08-15 20:09:33.000,"Mike Bostock","Mike Bostock",10,10,20,0,306
2013-08-15 18:03:30.000,"Mike Bostock","Mike Bostock",30,28,58,0,264
2013-08-15 17:27:52.000,"Mike Bostock","Mike Bostock",11,12,23,0,291
2013-08-15 17:22:10.000,"Mike Bostock","Mike Bostock",42,24,66,0,532
2013-08-15 04:55:29.000,"Mike Bostock","Mike Bostock",5,5,10,0,27
2013-08-15 04:52:57.000,"Mike Bostock","Mike Bostock",62,55,117,0,17
2013-08-15 04:47:49.000,"Mike Bostock","Mike Bostock",8,3,11,0,39
2013-08-15 04:07:14.000,"Mike Bostock","Mike Bostock",138,43,181,0,166
2013-08-14 23:50:31.000,"Mike Bostock","Mike Bostock",121,54,175,0,30
2013-08-15 01:19:58.000,"Mike Bostock","Mike Bostock",26,23,49,0,308
2013-08-14 21:38:21.000,"Mike Bostock","Mike Bostock",6,3,9,0,37
2013-08-14 21:08:10.000,"Mike Bostock","Mike Bostock",56,44,100,0,784
2013-08-14 17:58:28.000,"Mike Bostock","Mike Bostock",3,2,5,0,39
2013-08-13 22:37:08.000,"Mike Bostock","Mike Bostock",32,22,54,0,35
2013-08-13 22:19:07.000,"Mike Bostock","Mike Bostock",6,6,12,0,13
2013-08-13 22:17:26.000,"Mike Bostock","Mike Bostock",172,182,354,0,68
2013-08-13 22:16:39.000,"Mike Bostock","Mike Bostock",21,7,28,0,69
2013-08-13 22:13:55.000,"Mike Bostock","Mike Bostock",36,2,38,0,59
2013-08-13 22:13:21.000,"Mike Bostock","Mike Bostock",37,19,56,0,34
2013-08-13 22:12:43.000,"Mike Bostock","Mike Bostock",45,13,58,0,38
2013-08-13 22:12:06.000,"Mike Bostock","Mike Bostock",66,21,87,0,35
2013-08-13 19:00:38.000,"Mike Bostock","Mike Bostock",142,103,245,0,39
2013-08-13 18:07:51.000,"Mike Bostock","Mike Bostock",25,11,36,0,87
2013-08-13 01:08:58.000,"Mike Bostock","Mike Bostock",10,14,24,0,43
2013-08-13 00:50:08.000,"Mike Bostock","Mike Bostock",4,14,18,0,47
2013-08-13 00:47:39.000,"Mike Bostock","Mike Bostock",14,9,23,0,9
2013-08-13 00:39:23.000,"Mike Bostock","Mike Bostock",5,1,6,0,43
2013-08-13 00:32:40.000,"Mike Bostock","Mike Bostock",6,10,16,0,27
2013-08-12 22:37:24.000,"Mike Bostock","Mike Bostock",66,6,72,0,174
2013-08-11 08:13:24.000,"Mike Bostock","Mike Bostock",44,34,78,0,253
2013-08-09 20:34:41.000,"Mike Bostock","Mike Bostock",75,22,97,0,155
2013-08-12 16:17:45.000,"Mike Bostock","Mike Bostock",3,3,6,0,39
2013-08-10 18:23:24.000,"Mike Bostock","Mike Bostock",155,68,223,0,44
2013-06-29 18:12:34.000,"Mike Bostock","Mike Bostock",64,161,225,0,39
2013-08-10 05:09:43.000,"Mike Bostock","Mike Bostock",66,21,87,0,46
2013-08-10 04:52:03.000,"Mike Bostock","Mike Bostock",9,9,18,0,14
2013-08-10 04:32:19.000,"Mike Bostock","Mike Bostock",36,6,42,0,33
2013-08-10 04:19:52.000,"Mike Bostock","Mike Bostock",7,5,12,0,90
2013-08-05 18:47:22.000,"Mike Bostock","Mike Bostock",3,5,8,0,15
2013-08-05 18:44:59.000,"Mike Bostock","Mike Bostock",38,2,40,0,187
2013-08-02 23:03:24.000,"Mike Bostock","Mike Bostock",37,19,56,0,250
2013-08-01 15:37:51.000,"Mike Bostock","Mike Bostock",141,93,234,0,20
2013-08-01 15:37:00.000,"Mike Bostock","Mike Bostock",15,4,19,0,46
2013-08-01 15:36:26.000,"Mike Bostock","Mike Bostock",84,53,137,0,40
2013-08-01 15:36:02.000,"Mike Bostock","Mike Bostock",19,11,30,0,50
2013-08-01 15:35:21.000,"Mike Bostock","Mike Bostock",9,9,18,0,39
2013-08-01 15:33:51.000,"Mike Bostock","Mike Bostock",3,4,7,0,12
2013-08-01 15:31:35.000,"Mike Bostock","Mike Bostock",3,3,6,0,38
2013-08-01 15:30:31.000,"Mike Bostock","Mike Bostock",5,5,10,0,38
2013-08-01 15:29:32.000,"Mike Bostock","Mike Bostock",12,12,24,0,110
2013-08-01 15:28:49.000,"Mike Bostock","Mike Bostock",2,2,4,0,110
2013-08-01 15:27:59.000,"Mike Bostock","Mike Bostock",9,10,19,0,78
2013-07-31 22:39:01.000,"Jason Davies","Jason Davies",3,3,6,0,19
2013-07-31 22:31:22.000,"Mike Bostock","Mike Bostock",29,24,53,0,21
2013-07-31 21:28:41.000,"Jason Davies","Jason Davies",13,9,22,0,19
2013-07-31 19:00:11.000,"Mike Bostock","Mike Bostock",7,7,14,0,33
2013-07-31 18:40:07.000,"Mike Bostock","Mike Bostock",10,0,10,0,41
2013-07-29 21:27:08.000,"Leonardo Dutra","Leonardo Dutra",2,2,4,0,18
2013-07-29 21:25:05.000,"Leonardo Dutra","Leonardo Dutra",3,2,5,0,16
2013-07-28 21:46:17.000,"adnan","adnan",8,6,14,0,40
2013-07-24 22:39:27.000,"Leonardo Dutra","Leonardo Dutra",1,1,2,0,19
2013-07-24 22:04:52.000,"Leonardo Dutra","Leonardo Dutra",2,2,4,0,104
2013-07-24 21:59:28.000,"Leonardo Dutra","Leonardo Dutra",1,1,2,0,52
2013-07-24 21:51:35.000,"Leonardo Dutra","Leonardo Dutra",3,4,7,0,130
2013-07-24 20:01:18.000,"Leonardo Dutra","Leonardo Dutra",1,1,2,0,98
2013-07-24 19:58:58.000,"Leonardo Dutra","Leonardo Dutra",1,1,2,0,137
2013-07-24 19:11:45.000,"Mike Bostock","Mike Bostock",19,11,30,0,181
2013-07-23 23:23:38.000,"Jason Davies","Jason Davies",70,49,119,0,492
2013-07-23 19:52:51.000,"Jason Davies","Jason Davies",6,5,11,0,762
2013-07-22 12:55:24.000,"Mike Bostock","Mike Bostock",3,3,6,0,267
2013-07-21 17:55:17.000,"Mike Bostock","Mike Bostock",16,5,21,0,36
2013-07-19 04:30:09.000,"Mike Bostock","Mike Bostock",5,4,9,0,35
2013-07-19 04:17:22.000,"Mike Bostock","Mike Bostock",525,546,1071,0,20
2013-07-19 04:15:03.000,"Mike Bostock","Mike Bostock",3,3,6,0,45
2013-07-19 04:14:37.000,"Mike Bostock","Mike Bostock",51,47,98,0,55
2013-07-19 04:14:06.000,"Mike Bostock","Mike Bostock",16,18,34,0,46
2013-07-19 04:13:40.000,"Mike Bostock","Mike Bostock",10,14,24,0,47
2013-07-19 03:53:21.000,"Mike Bostock","Mike Bostock",99,127,226,0,426
2013-07-12 23:04:43.000,"Mike Bostock","Mike Bostock",350,341,691,0,21
2013-07-19 01:56:25.000,"Mike Bostock","Mike Bostock",14,18,32,0,172
2013-07-18 21:25:38.000,"Mike Bostock","Mike Bostock",15,20,35,0,304
2013-07-18 20:07:41.000,"Mike Bostock","Mike Bostock",6,3,9,0,60
2013-07-18 18:07:14.000,"Mike Bostock","Mike Bostock",51,47,98,0,239
2013-07-16 18:48:46.000,"Mike Bostock","Mike Bostock",3,3,6,0,322
2013-07-12 17:38:35.000,"Mike Bostock","Mike Bostock",35,10,45,0,13
2013-07-12 01:21:38.000,"Mike Bostock","Mike Bostock",4,2,6,0,26
2013-07-12 00:54:20.000,"Mike Bostock","Mike Bostock",341,322,663,0,20
2013-07-12 00:53:02.000,"Mike Bostock","Mike Bostock",88,102,190,0,48
2013-07-12 00:52:23.000,"Mike Bostock","Mike Bostock",223,196,419,0,49
2013-07-12 00:51:38.000,"Mike Bostock","Mike Bostock",31,25,56,0,53
2013-07-11 23:19:33.000,"Mike Bostock","Mike Bostock",13,13,26,0,9
2013-07-11 21:48:46.000,"Mike Bostock","Mike Bostock",32,8,40,0,38
2013-07-11 20:55:34.000,"Mike Bostock","Mike Bostock",58,96,154,0,44
2013-07-11 05:49:44.000,"Mike Bostock","Mike Bostock",0,1,1,0,22
2013-07-11 05:48:37.000,"Mike Bostock","Mike Bostock",0,1,1,0,46
2013-07-11 02:05:38.000,"Mike Bostock","Mike Bostock",33,29,62,0,524
2013-07-10 18:47:06.000,"Mike Bostock","Mike Bostock",127,110,237,0,899
2013-07-10 18:04:21.000,"Mike Bostock","Mike Bostock",91,86,177,0,323
2013-07-10 17:02:10.000,"Mike Bostock","Mike Bostock",10,9,19,0,347
2013-07-06 22:55:44.000,"Mike Bostock","Mike Bostock",12,12,24,0,22
2013-07-06 22:52:59.000,"Mike Bostock","Mike Bostock",22,16,38,0,400
2013-07-06 04:13:41.000,"Mike Bostock","Mike Bostock",12,14,26,0,42
2013-07-05 23:39:56.000,"Jason Davies","Jason Davies",1,1,2,0,34
2013-07-05 23:34:17.000,"Jason Davies","Jason Davies",22,7,29,0,460
2013-07-05 19:20:20.000,"Mike Bostock","Mike Bostock",6,6,12,0,13
2013-07-05 19:19:53.000,"Mike Bostock","Mike Bostock",138,64,202,0,43
2013-07-05 19:19:30.000,"Mike Bostock","Mike Bostock",12,13,25,0,47
2013-07-05 19:19:04.000,"Mike Bostock","Mike Bostock",262,171,433,0,43
2013-07-03 17:52:28.000,"Mike Bostock","Mike Bostock",261,170,431,0,508
2013-07-05 18:45:24.000,"Mike Bostock","Mike Bostock",86,17,103,0,47
2013-07-05 18:44:58.000,"Mike Bostock","Mike Bostock",13,23,36,0,42
2013-07-05 18:32:37.000,"Mike Bostock","Mike Bostock",51,12,63,0,190
2013-07-05 18:00:29.000,"Mike Bostock","Mike Bostock",91,56,147,0,729
2013-07-04 18:35:30.000,"Mike Bostock","Mike Bostock",12,13,25,0,46
2013-07-04 18:14:18.000,"Mike Bostock","Mike Bostock",12,14,26,0,36
2013-06-28 23:15:09.000,"Mike Bostock","Mike Bostock",51,23,74,0,383
2013-07-03 18:08:27.000,"Mike Bostock","Mike Bostock",455,355,810,0,85
2013-07-03 18:05:14.000,"Mike Bostock","Mike Bostock",2,2,4,0,29
2013-07-02 01:49:18.000,"Mike Bostock","Mike Bostock",11,21,32,0,462
2013-07-03 05:09:53.000,"Mike Bostock","Mike Bostock",10,4,14,0,92
2013-07-02 18:28:23.000,"Mike Bostock","Mike Bostock",20,2,22,0,43
2013-07-02 18:23:10.000,"Mike Bostock","Mike Bostock",3,7,10,0,14
2013-07-02 18:22:18.000,"Mike Bostock","Mike Bostock",22,0,22,0,26
2013-07-02 17:07:38.000,"Mike Bostock","Mike Bostock",52,25,77,0,438
2013-07-01 19:10:05.000,"Mike Bostock","Mike Bostock",437,349,786,0,20
2013-07-01 19:08:34.000,"Mike Bostock","Mike Bostock",36,9,45,0,50
2013-07-01 19:08:08.000,"Mike Bostock","Mike Bostock",54,66,120,0,51
2013-07-01 19:07:45.000,"Mike Bostock","Mike Bostock",224,139,363,0,42
2013-07-01 19:07:10.000,"Mike Bostock","Mike Bostock",130,142,272,0,51
2013-07-01 19:05:15.000,"Mike Bostock","Mike Bostock",18,6,24,0,36
2013-07-01 16:48:49.000,"Mike Bostock","Mike Bostock",1,4,5,0,23
2013-06-30 18:50:57.000,"Mike Bostock","Mike Bostock",6,0,6,0,26
2013-06-30 18:33:17.000,"Mike Bostock","Mike Bostock",48,66,114,0,1021
2013-06-30 18:02:58.000,"Mike Bostock","Mike Bostock",36,9,45,0,46
2013-06-30 17:53:33.000,"Mike Bostock","Mike Bostock",22,8,30,0,28
2013-06-30 01:47:17.000,"Mike Bostock","Mike Bostock",2,1,3,0,18
2013-06-29 18:26:38.000,"Mike Bostock","Mike Bostock",8,8,16,0,32
2013-06-29 17:24:41.000,"Mike Bostock","Mike Bostock",8,8,16,0,33
2013-06-29 17:18:37.000,"Mike Bostock","Mike Bostock",44,0,44,0,68
2013-06-29 17:03:09.000,"Mike Bostock","Mike Bostock",2,0,2,0,39
2013-06-29 07:01:06.000,"Jared Forsyth","Jared Forsyth",37,3,40,0,20
2013-06-29 05:58:25.000,"Jared Forsyth","Jared Forsyth",10,0,10,0,27
2013-06-28 23:35:19.000,"Mike Bostock","Mike Bostock",122,134,256,0,600
2013-06-28 16:29:16.000,"Mike Bostock","Mike Bostock",168,145,313,0,398
2013-06-27 21:29:38.000,"Mike Bostock","Mike Bostock",67,11,78,0,194
2013-06-27 21:28:52.000,"Mike Bostock","Mike Bostock",1,1,2,0,30
2013-06-27 20:58:15.000,"Mike Bostock","Mike Bostock",13,7,20,0,39
2013-06-27 19:32:08.000,"Mike Bostock","Mike Bostock",46,20,66,5,38
2013-06-27 17:47:33.000,"Mike Bostock","Mike Bostock",0,0,0,0,27
2013-06-27 17:46:35.000,"Mike Bostock","Mike Bostock",14,25,39,0,33
2013-06-26 16:04:35.000,"Mike Bostock","Mike Bostock",62,0,62,0,83
2013-06-26 08:53:26.000,"Jason Davies","Jason Davies",13,6,19,0,219
2013-06-26 01:07:20.000,"Mike Bostock","Mike Bostock",5,5,10,0,15
2013-06-26 01:06:36.000,"Mike Bostock","Mike Bostock",270,288,558,0,39
2013-06-26 01:01:21.000,"Mike Bostock","Mike Bostock",93,6,99,0,45
2013-06-26 00:53:02.000,"Mike Bostock","Mike Bostock",27,30,57,0,24
2013-06-26 00:46:13.000,"Mike Bostock","Mike Bostock",64,86,150,0,405
2013-06-25 16:34:30.000,"Mike Bostock","Mike Bostock",1,1,2,0,16
2013-06-25 15:59:21.000,"Mike Bostock","Mike Bostock",27,45,72,0,101
2013-06-25 10:00:37.000,"Jason Davies","Jason Davies",12,10,22,0,422
2013-06-24 23:37:28.000,"Erik Cunningham","Erik Cunningham",0,2,2,0,27
2013-06-24 23:35:06.000,"Erik Cunningham","Erik Cunningham",46,1,47,0,39
2013-06-24 22:28:54.000,"Erik Cunningham","Erik Cunningham",19,0,19,0,27
2013-06-21 16:51:53.000,"Mike Bostock","Mike Bostock",7,7,14,0,13
2013-06-21 16:44:08.000,"Mike Bostock","Mike Bostock",3,3,6,0,36
2013-06-21 16:24:29.000,"Mike Bostock","Mike Bostock",5,5,10,0,335
2013-06-20 16:52:00.000,"Mike Bostock","Mike Bostock",86,1,87,0,37
2013-06-20 03:03:29.000,"adnan","adnan",7,5,12,0,19
2013-06-19 18:55:00.000,"Mike Bostock","Mike Bostock",85,38,123,0,20
2013-06-19 18:53:51.000,"Mike Bostock","Mike Bostock",25,6,31,0,30
2013-06-19 18:53:03.000,"Mike Bostock","Mike Bostock",8,5,13,0,37
2013-06-19 18:52:10.000,"Mike Bostock","Mike Bostock",7,7,14,0,55
2013-06-19 18:50:26.000,"Mike Bostock","Mike Bostock",5,5,10,0,28
2013-06-19 00:16:47.000,"Mike Bostock","Mike Bostock",8,13,21,0,592
2013-06-18 23:59:16.000,"Mike Bostock","Mike Bostock",11,9,20,0,169
2013-06-18 18:33:01.000,"Mike Bostock","Mike Bostock",13,13,26,0,17
2013-06-18 18:20:11.000,"Mike Bostock","Mike Bostock",45,17,62,0,1083
2013-06-14 19:37:18.000,"Mike Bostock","Mike Bostock",3,3,6,0,41
2013-06-14 10:10:00.000,"Jason Davies","Jason Davies",8,5,13,0,150
2013-06-07 21:54:11.000,"Jason Davies","Jason Davies",25,6,31,0,38
2013-06-13 23:47:51.000,"Mike Bostock","Mike Bostock",2850,1380,4230,0,18
2013-06-13 23:23:39.000,"Mike Bostock","Mike Bostock",16,0,16,0,34
2013-06-13 23:19:51.000,"Mike Bostock","Mike Bostock",17,13,30,0,14
2013-06-13 22:00:03.000,"Mike Bostock","Mike Bostock",87,77,164,0,38
2013-06-13 00:40:19.000,"Mike Bostock","Mike Bostock",41,37,78,0,298
2013-06-13 00:07:42.000,"Mike Bostock","Mike Bostock",77,34,111,0,35
2013-06-12 21:19:20.000,"Mike Bostock","Mike Bostock",45,30,75,0,585
2013-05-31 23:13:50.000,"Jason Davies","Jason Davies",77,34,111,5,700
2013-06-11 23:59:55.000,"Mike Bostock","Mike Bostock",18,18,36,0,117
2013-06-11 23:33:43.000,"Mike Bostock","Mike Bostock",7,7,14,0,39
2013-06-11 20:22:18.000,"Mike Bostock","Mike Bostock",10,13,23,0,18
2013-06-11 20:19:20.000,"Mike Bostock","Mike Bostock",43,50,93,0,28
2013-06-11 10:18:25.000,"Jason Davies","Jason Davies",124,22,146,0,186
2013-06-08 20:53:37.000,"Jason Davies","Jason Davies",0,2,2,0,49
2012-08-13 11:51:29.000,"Jason Davies","Jason Davies",167,42,209,0,99
2013-06-08 18:57:22.000,"Jason Davies","Jason Davies",524,111,635,0,163
2013-06-08 17:12:35.000,"Jason Davies","Jason Davies",34,32,66,0,134
2013-06-08 16:08:25.000,"Jason Davies","Jason Davies",1,1,2,0,12
2013-06-04 19:38:37.000,"Mike Bostock","Mike Bostock",3,3,6,0,95
2013-06-04 19:33:15.000,"Jason Davies","Jason Davies",3,3,6,0,50
2013-06-04 02:13:28.000,"Mike Bostock","Mike Bostock",165,0,165,0,32
2013-06-03 21:28:46.000,"Mike Bostock","Mike Bostock",3,11,14,0,250
2013-06-03 21:23:41.000,"Mike Bostock","Mike Bostock",1,1,2,0,27
2013-01-15 22:50:42.000,"Jason Davies","Jason Davies",291,191,482,0,971
2013-06-01 18:11:46.000,"Mike Bostock","Mike Bostock",9,7,16,0,45
2013-06-01 17:44:04.000,"Mike Bostock","Mike Bostock",18,8,26,3,142
2013-05-30 23:14:12.000,"Mike Bostock","Mike Bostock",25,3,28,0,56
2013-05-30 22:48:08.000,"Mike Bostock","Mike Bostock",17,6,23,0,51
2013-05-30 22:23:50.000,"Mike Bostock","Mike Bostock",55,25,80,0,67
2013-05-30 20:26:24.000,"Mike Bostock","Mike Bostock",72,3,75,0,32
2013-05-30 20:19:52.000,"Mike Bostock","Mike Bostock",56,18,74,0,33
2013-05-30 20:18:38.000,"Mike Bostock","Mike Bostock",13,13,26,0,27
2013-05-30 20:15:22.000,"Mike Bostock","Mike Bostock",44,7,51,0,77
2013-05-30 20:04:35.000,"Mike Bostock","Mike Bostock",21,4,25,0,48
2013-05-30 19:48:44.000,"Mike Bostock","Mike Bostock",98,76,174,0,36
2013-05-30 19:45:08.000,"Mike Bostock","Mike Bostock",29,5,34,0,64
2013-05-30 19:38:07.000,"Mike Bostock","Mike Bostock",47,5,52,0,56
2013-05-30 19:34:47.000,"Mike Bostock","Mike Bostock",69,28,97,0,36
2013-05-30 19:30:42.000,"Mike Bostock","Mike Bostock",23,16,39,0,39
2013-05-30 19:29:47.000,"Mike Bostock","Mike Bostock",3,1,4,0,55
2013-05-30 19:29:09.000,"Mike Bostock","Mike Bostock",15,5,20,0,43
2013-05-30 19:27:41.000,"Mike Bostock","Mike Bostock",3,3,6,0,35
2013-05-30 19:26:43.000,"Mike Bostock","Mike Bostock",72,34,106,0,35
2013-05-30 19:26:14.000,"Mike Bostock","Mike Bostock",10,8,18,0,47
2013-05-30 19:25:46.000,"Mike Bostock","Mike Bostock",1,1,2,0,30
2013-05-30 19:25:12.000,"Mike Bostock","Mike Bostock",36,23,59,0,42
2013-05-30 19:24:29.000,"Mike Bostock","Mike Bostock",774,718,1492,0,36
2013-01-30 19:15:37.000,"Mike Bostock","Mike Bostock",95,74,169,0,104
2013-05-02 15:13:41.000,"Jason Davies","Mike Bostock",46,26,72,0,47
2012-12-14 15:21:51.000,"Jason Davies","Mike Bostock",30,9,39,0,788
2013-05-30 18:03:57.000,"Mike Bostock","Mike Bostock",1,3,4,0,47
2013-05-29 22:57:30.000,"Mike Bostock","Mike Bostock",14,10,24,0,29
2013-05-29 22:37:46.000,"Mike Bostock","Mike Bostock",44,56,100,0,38
2013-05-29 21:13:53.000,"Jason Davies","Jason Davies",11,0,11,0,41
2013-05-29 19:48:42.000,"Jason Davies","Jason Davies",767,714,1481,0,352
2013-05-29 18:55:20.000,"Mike Bostock","Mike Bostock",8,11,19,0,17
2013-05-29 18:52:21.000,"Mike Bostock","Mike Bostock",17,21,38,0,21
2013-05-29 18:49:37.000,"Mike Bostock","Mike Bostock",22,2,24,0,82
2013-05-29 16:21:26.000,"Jason Davies","Jason Davies",6,6,12,0,71
2013-05-29 01:08:15.000,"Mike Bostock","Mike Bostock",12,10,22,0,50
2013-05-29 00:48:03.000,"Jason Davies","Jason Davies",74,36,110,0,297
2013-05-29 00:43:21.000,"Mike Bostock","Mike Bostock",3,3,6,0,247
2013-05-29 00:23:53.000,"Ryan Alexander","Ryan Alexander",17,0,17,0,48
2013-05-28 23:59:53.000,"Mike Bostock","Mike Bostock",202,161,363,0,21
2013-05-28 23:56:31.000,"Mike Bostock","Mike Bostock",38,39,77,0,49
2013-05-28 23:55:57.000,"Mike Bostock","Mike Bostock",42,10,52,0,43
2013-05-28 23:55:13.000,"Mike Bostock","Mike Bostock",42,8,50,0,42
2013-05-28 23:51:36.000,"Mike Bostock","Mike Bostock",30,83,113,0,17
2013-05-28 23:44:38.000,"Mike Bostock","Mike Bostock",36,13,49,0,20
2013-05-28 23:44:08.000,"Mike Bostock","Mike Bostock",36,7,43,0,97
2013-05-20 20:21:59.000,"Mike Bostock","Mike Bostock",14,4,18,0,204
2013-05-28 22:17:20.000,"Mike Bostock","Mike Bostock",8,8,16,0,23
2013-05-28 22:15:15.000,"Mike Bostock","Mike Bostock",5,6,11,0,11
2013-05-28 22:10:17.000,"Mike Bostock","Mike Bostock",21,35,56,0,523
2013-05-28 21:58:39.000,"Mike Bostock","Mike Bostock",3,3,6,0,19
2013-05-28 21:57:26.000,"Mike Bostock","Mike Bostock",0,18,18,0,41
2013-05-28 21:50:41.000,"Mike Bostock","Mike Bostock",41,58,99,0,419
2013-05-28 21:50:04.000,"Mike Bostock","Mike Bostock",23,23,46,0,45
2013-05-28 21:29:21.000,"Mike Bostock","Mike Bostock",55,29,84,0,300
2013-05-28 09:10:50.000,"Ryan Alexander","Ryan Alexander",2,2,4,0,25
2013-05-28 09:04:26.000,"Ryan Alexander","Ryan Alexander",5,2,7,0,62
2013-05-26 05:54:51.000,"Freeyorp","Freeyorp",28,5,33,0,781
2013-05-25 01:30:13.000,"Carlos Rendon","Carlos Rendon",30,4,34,0,48
2013-05-25 01:08:39.000,"Carlos Rendon","Carlos Rendon",2,3,5,0,15
2013-05-25 00:35:49.000,"Carlos Rendon","crendon",6,7,13,0,29
2013-05-24 20:37:58.000,"Jason Davies","Jason Davies",35,1,36,0,53
2013-05-24 18:59:50.000,"Jason Davies","Jason Davies",7,7,14,0,45
2013-05-23 00:59:45.000,"Mike Bostock","Mike Bostock",42,10,52,2,343
2013-05-22 03:36:27.000,"Carlos Rendon","Carlos Rendon",4,4,8,0,31
2013-05-22 02:58:52.000,"Carlos Rendon","Carlos Rendon",1,21,22,0,21
2013-05-21 18:01:02.000,"Carlos Rendon","Carlos Rendon",31,7,38,0,25
2013-05-21 00:08:32.000,"Carlos Rendon","Carlos Rendon",6,5,11,0,207
2013-05-20 21:36:44.000,"Mike Bostock","Mike Bostock",25,16,41,0,219
2013-05-20 18:40:20.000,"Mike Bostock","Mike Bostock",10,19,29,0,34
2013-05-20 18:31:07.000,"Mike Bostock","Mike Bostock",255,208,463,0,20
2013-05-20 18:29:57.000,"Mike Bostock","Mike Bostock",12,12,24,0,40
2013-05-20 18:26:27.000,"Mike Bostock","Mike Bostock",15,15,30,0,170
2013-05-20 18:03:10.000,"Mike Bostock","Mike Bostock",34,25,59,0,24
2013-05-20 17:45:41.000,"Mike Bostock","Mike Bostock",38,20,58,0,34
2013-05-20 17:39:50.000,"Mike Bostock","Mike Bostock",1,0,1,0,19
2013-05-20 13:30:01.000,"Jason Davies","Jason Davies",4,9,13,0,15
2013-05-20 13:23:59.000,"Jason Davies","Jason Davies",16,14,30,0,45
2013-05-20 13:15:25.000,"Jason Davies","Jason Davies",17,17,34,0,27
2013-05-20 13:05:32.000,"Jason Davies","Jason Davies",5,5,10,0,242
2013-05-20 08:46:13.000,"Jason Davies","Jason Davies",2,1,3,0,255
2013-05-20 06:02:51.000,"Mike Bostock","Mike Bostock",18,3,21,0,31
2013-05-20 05:59:38.000,"Mike Bostock","Mike Bostock",79,62,141,0,33
2013-05-20 00:28:29.000,"Mike Bostock","Mike Bostock",5,5,10,0,20
2013-05-20 00:13:32.000,"Mike Bostock","Mike Bostock",22,18,40,0,108
2013-05-19 21:04:38.000,"Mike Bostock","Mike Bostock",5,8,13,0,17
2013-05-19 20:58:50.000,"Mike Bostock","Mike Bostock",5,5,10,0,37
2013-05-19 19:46:10.000,"Mike Bostock","Mike Bostock",24,24,48,0,34
2013-05-19 19:38:22.000,"Mike Bostock","Mike Bostock",108,120,228,0,560
2013-05-17 04:39:20.000,"shilad","shilad",1,0,1,0,57
2013-05-16 00:11:34.000,"Mike Bostock","Mike Bostock",5,5,10,0,13
2013-05-16 00:10:44.000,"Mike Bostock","Mike Bostock",40,32,72,0,64
2013-05-16 00:10:30.000,"Mike Bostock","Mike Bostock",85,63,148,0,65
2013-05-16 00:09:58.000,"Mike Bostock","Mike Bostock",10,6,16,0,63
2013-05-16 00:09:31.000,"Mike Bostock","Mike Bostock",51,3,54,0,58
2013-05-16 00:09:02.000,"Mike Bostock","Mike Bostock",486,111,597,0,59
2013-05-16 00:05:25.000,"Mike Bostock","Mike Bostock",2,2,4,0,94
2013-05-15 23:48:13.000,"Mike Bostock","Mike Bostock",34,28,62,0,490
2013-05-13 23:11:59.000,"Mike Bostock","Mike Bostock",84,62,146,0,328
2013-05-08 11:39:28.000,"Jason Davies","Jason Davies",2,2,4,0,333
2013-05-08 10:44:22.000,"Jason Davies","Jason Davies",2,4,6,0,118
2013-05-05 00:48:59.000,"Jason Davies","Jason Davies",18,13,31,0,285
2013-03-21 21:47:12.000,"Jason Davies","Jason Davies",486,111,597,0,1387
2013-05-04 12:31:43.000,"Jason Davies","Jason Davies",51,3,54,0,204
2013-05-01 18:23:56.000,"Jason Davies","Jason Davies",9,5,14,0,575
2013-05-01 00:09:40.000,"Mike Bostock","Mike Bostock",14,4,18,0,49
2013-04-30 23:56:30.000,"Mike Bostock","Mike Bostock",321,166,487,0,20
2013-04-30 23:55:25.000,"Mike Bostock","Mike Bostock",171,32,203,0,35
2013-04-30 23:54:43.000,"Mike Bostock","Mike Bostock",37,49,86,0,37
2013-04-30 23:54:06.000,"Mike Bostock","Mike Bostock",69,33,102,0,36
2013-04-30 23:53:31.000,"Mike Bostock","Mike Bostock",9,20,29,0,30
2013-04-30 23:52:32.000,"Mike Bostock","Mike Bostock",2,2,4,0,31
2013-04-19 22:06:41.000,"Mike Bostock","Mike Bostock",41,38,79,0,35
2013-04-30 23:30:56.000,"Mike Bostock","Mike Bostock",11,7,18,0,34
2013-04-30 23:17:22.000,"Mike Bostock","Mike Bostock",27,43,70,0,11
2013-04-30 22:46:32.000,"Mike Bostock","Mike Bostock",55,29,84,0,322
2013-04-30 22:12:02.000,"Mike Bostock","Mike Bostock",17,7,24,0,60
2013-04-25 20:33:06.000,"Mike Bostock","Mike Bostock",1,1,2,0,12
2013-04-25 19:48:02.000,"Mike Bostock","Mike Bostock",17,71,88,3,38
2013-04-20 20:50:36.000,"Mike Bostock","Mike Bostock",56,18,74,0,40
2013-04-19 22:57:41.000,"Mike Bostock","Mike Bostock",22,16,38,0,33
2013-04-19 18:36:10.000,"Mike Bostock","Mike Bostock",9,20,29,0,22
2013-04-19 18:20:21.000,"Mike Bostock","Mike Bostock",171,32,203,0,674
2013-04-18 04:28:07.000,"Scott Cheng","Scott Cheng",12,0,12,0,95
2013-04-18 04:12:19.000,"Scott Cheng","Scott Cheng",1,0,1,0,67
2013-04-17 17:56:37.000,"Scott Cheng","Scott Cheng",5,0,5,0,64
2013-04-17 17:55:10.000,"Scott Cheng","Scott Cheng",3,8,11,0,56
2013-04-17 15:47:30.000,"Scott Cheng","Scott Cheng",7,0,7,0,40
2013-04-17 15:34:19.000,"Scott Cheng","Scott Cheng",7,6,13,0,66
2013-04-17 12:18:18.000,"Scott Cheng","Scott Cheng",2,2,4,0,47
2013-04-15 15:52:57.000,"Scott Cheng","Scott Cheng",11,1,12,0,25
2013-04-11 18:20:44.000,"Jason Davies","Jason Davies",1,1,2,0,29
2013-04-11 17:21:37.000,"Mike Bostock","Mike Bostock",3,3,6,0,62
2013-04-11 15:26:06.000,"Chia-liang Kao","Chia-liang Kao",1,1,2,0,24
2013-04-11 15:20:30.000,"Chia-liang Kao","Chia-liang Kao",2,2,4,0,26
2013-04-07 03:29:44.000,"Mike Bostock","Mike Bostock",243,144,387,0,20
2013-04-07 03:27:55.000,"Mike Bostock","Mike Bostock",22,30,52,0,35
2013-04-07 03:21:36.000,"Mike Bostock","Mike Bostock",36,28,64,0,73
2013-04-07 03:16:38.000,"Mike Bostock","Mike Bostock",12,6,18,0,43
2013-04-07 03:16:12.000,"Mike Bostock","Mike Bostock",203,110,313,0,41
2013-04-05 04:49:57.000,"Mike Bostock","Mike Bostock",12,6,18,0,23
2013-04-03 18:54:52.000,"Mike Bostock","Mike Bostock",7,1,8,0,29
2013-04-03 18:54:21.000,"Mike Bostock","Mike Bostock",7,1,8,0,73
2013-04-03 18:46:15.000,"Mike Bostock","Mike Bostock",7,5,12,0,31
2013-04-03 18:44:13.000,"Mike Bostock","Mike Bostock",6,2,8,0,97
2013-04-03 15:29:14.000,"Dan Milon","Dan Milon",6,2,8,0,21
2013-04-02 17:02:09.000,"Mike Bostock","Mike Bostock",12,0,12,0,40
2013-04-02 21:56:07.000,"Mike Bostock","Mike Bostock",1,0,1,0,68
2013-04-02 18:21:29.000,"JD Isaacks","JD Isaacks",4,13,17,0,56
2013-04-02 17:16:50.000,"JD Isaacks","JD Isaacks",28,25,53,0,48
2013-04-02 17:00:45.000,"John Firebaugh","John Firebaugh",1,0,1,0,18
2013-04-02 15:58:44.000,"JD Isaacks","JD Isaacks",47,6,53,0,65
2013-03-31 17:48:10.000,"Mike Bostock","Mike Bostock",53,53,106,0,30
2013-03-31 17:46:07.000,"Mike Bostock","Mike Bostock",150,57,207,0,122
2013-03-30 00:23:57.000,"Dan Tillberg","Dan Tillberg",18,13,31,0,130
2013-03-27 06:45:50.000,"Lee Leathers","Lee Leathers",7,1,8,0,44
2013-03-26 22:11:06.000,"Adam Sunderland","Adam Sunderland",4,4,8,0,48
2013-03-26 20:01:05.000,"Adam Sunderland","Adam Sunderland",3,3,6,0,31
2013-03-26 19:50:54.000,"Adam Sunderland","Adam Sunderland",17,0,17,0,42
2013-03-25 10:29:37.000,"Jason Davies","Jason Davies",3,0,3,0,159
2013-03-25 08:51:16.000,"Jason Davies","Jason Davies",21,0,21,0,50
2013-03-24 23:51:00.000,"Mike Bostock","Mike Bostock",10,10,20,0,32
2013-03-24 23:44:28.000,"Mike Bostock","Mike Bostock",5,5,10,0,42
2013-03-22 22:38:56.000,"Mike Bostock","Mike Bostock",71,13,84,0,353
2013-03-21 23:59:50.000,"Jason Davies","Jason Davies",30,0,30,0,37
2013-03-21 23:52:26.000,"Mike Bostock","Mike Bostock",8,6,14,0,31
2013-03-21 23:46:26.000,"Mike Bostock","Mike Bostock",15,20,35,0,26
2013-03-21 23:41:40.000,"Jason Davies","Jason Davies",11,16,27,0,47
2013-03-21 22:54:53.000,"Mike Bostock","Mike Bostock",17609,14616,32225,0,20
2013-03-21 22:24:53.000,"Jason Davies","Jason Davies",0,3,3,0,30
2013-03-21 22:01:51.000,"Jason Davies","Jason Davies",19,19,38,0,23
2013-03-21 21:49:19.000,"Jason Davies","Jason Davies",4,4,8,0,29
2013-03-21 12:56:54.000,"Jason Davies","Jason Davies",11,11,22,0,31
2013-03-21 04:54:33.000,"Mike Bostock","Mike Bostock",15,29,44,0,41
2013-03-21 04:34:12.000,"Mike Bostock","Mike Bostock",435,3,438,0,64
2013-03-20 09:12:09.000,"Jason Davies","Jason Davies",2,2,4,0,21
2013-03-19 17:19:21.000,"Jason Davies","Jason Davies",305,199,504,0,22
2013-03-19 16:43:05.000,"Jason Davies","Jason Davies",4,4,8,0,9
2013-03-19 16:39:39.000,"Jason Davies","Jason Davies",60,46,106,0,41
2013-03-19 16:30:45.000,"Jason Davies","Jason Davies",14,15,29,0,9
2013-03-19 16:25:28.000,"Jason Davies","Jason Davies",40,26,66,0,42
2013-03-19 16:14:43.000,"Jason Davies","Jason Davies",8,6,14,0,37
2013-03-19 16:13:11.000,"Jason Davies","Jason Davies",33,32,65,0,39
2013-03-19 16:02:09.000,"Jason Davies","Jason Davies",24,19,43,0,42
2013-03-19 15:56:24.000,"Jason Davies","Jason Davies",48,46,94,0,76
2013-03-19 15:54:57.000,"Jason Davies","Jason Davies",1,2,3,1,40
2013-03-19 15:53:53.000,"Jason Davies","Jason Davies",3,3,6,0,51
2013-03-19 15:50:07.000,"Jason Davies","Jason Davies",3,1,4,0,41
2013-03-19 15:44:00.000,"Jason Davies","Jason Davies",22,20,42,0,29
2013-03-19 15:30:37.000,"Jason Davies","Jason Davies",9,7,16,0,46
2013-03-19 15:26:02.000,"Jason Davies","Jason Davies",5,3,8,0,46
2013-03-19 15:21:06.000,"Jason Davies","Jason Davies",2,2,4,0,39
2013-03-19 15:19:29.000,"Jason Davies","Jason Davies",6,6,12,0,42
2013-03-19 15:17:00.000,"Jason Davies","Jason Davies",37,37,74,0,78
2013-03-19 15:10:29.000,"Jason Davies","Jason Davies",19,7,26,0,44
2013-03-19 10:53:08.000,"Jason Davies","Jason Davies",282,182,464,0,38
2013-03-19 10:33:56.000,"Jason Davies","Jason Davies",2546,2560,5106,0,37
2013-03-19 10:54:40.000,"Jason Davies","Jason Davies",4,4,8,0,24
2013-03-16 22:23:26.000,"Ilya Boyandin","Ilya Boyandin",3,3,6,0,85
2013-03-16 19:44:34.000,"Mike Bostock","Mike Bostock",4,1,5,0,20
2013-03-16 15:49:48.000,"Jason Davies","Jason Davies",8,5,13,4,267
2013-03-16 00:18:26.000,"Mike Bostock","Mike Bostock",10,8,18,0,11
2013-03-16 00:15:20.000,"Mike Bostock","Mike Bostock",36,18,54,0,205
2013-03-16 00:15:07.000,"Mike Bostock","Mike Bostock",3,1,4,0,18
2013-03-15 23:30:20.000,"Jason Davies","Jason Davies",99,19,118,0,40
2013-03-15 17:09:55.000,"Mike Bostock","Mike Bostock",58,56,114,0,21
2013-03-15 16:55:53.000,"Jason Davies","Jason Davies",60,0,60,0,44
2013-03-15 15:27:24.000,"Mike Bostock","Mike Bostock",10,12,22,0,26
2013-03-15 15:01:47.000,"Jason Davies","Jason Davies",4,4,8,1,216
2013-03-14 22:43:18.000,"Jason Davies","Jason Davies",3,3,6,0,22
2013-03-14 22:30:24.000,"Mike Bostock","Mike Bostock",5,5,10,0,20
2013-03-14 22:14:12.000,"Mike Bostock","Mike Bostock",193,192,385,0,42
2013-03-14 21:49:08.000,"Jason Davies","Jason Davies",5,5,10,0,22
2013-03-14 11:44:45.000,"Jason Davies","Jason Davies",17,5,22,0,90
2013-03-14 21:32:13.000,"Mike Bostock","Mike Bostock",3,3,6,0,29
2013-03-14 21:28:25.000,"Mike Bostock","Mike Bostock",2,0,2,0,30
2013-03-14 21:12:47.000,"Mike Bostock","Mike Bostock",125,125,250,0,24
2013-03-14 21:11:40.000,"Mike Bostock","Mike Bostock",22,14,36,0,18
2013-03-14 20:59:18.000,"Mike Bostock","Mike Bostock",114,132,246,0,40
2013-03-14 20:29:24.000,"Mike Bostock","Mike Bostock",606,630,1236,0,37
2013-03-14 19:59:54.000,"Mike Bostock","Mike Bostock",170,174,344,0,33
2013-03-14 19:58:16.000,"Mike Bostock","Mike Bostock",188,270,458,0,29
2013-03-14 19:36:21.000,"Mike Bostock","Mike Bostock",523,740,1263,0,59
2013-03-14 17:58:17.000,"Mike Bostock","Mike Bostock",18,8,26,0,218
2013-03-14 17:52:01.000,"Mike Bostock","Mike Bostock",197,203,400,0,38
2013-03-14 17:34:50.000,"Mike Bostock","Mike Bostock",192,195,387,0,42
2013-03-14 17:03:10.000,"Jason Davies","Jason Davies",2716,2392,5108,0,45
2013-03-14 17:18:11.000,"Mike Bostock","Mike Bostock",1004,877,1881,0,47
2013-03-14 16:43:53.000,"Mike Bostock","Mike Bostock",72,71,143,0,40
2013-03-14 16:41:29.000,"Mike Bostock","Mike Bostock",537,605,1142,0,39
2013-03-14 16:19:27.000,"Mike Bostock","Mike Bostock",388,388,776,0,42
2013-03-14 16:17:39.000,"Mike Bostock","Mike Bostock",45,48,93,0,41
2013-03-14 16:16:05.000,"Mike Bostock","Mike Bostock",46,57,103,0,39
2013-03-14 16:09:50.000,"Mike Bostock","Mike Bostock",52,46,98,0,39
2013-03-14 16:06:31.000,"Mike Bostock","Mike Bostock",180,176,356,0,41
2013-03-14 16:00:13.000,"Mike Bostock","Mike Bostock",767,763,1530,0,41
2013-03-14 15:46:45.000,"Mike Bostock","Mike Bostock",44,56,100,0,31
2013-03-14 15:42:29.000,"Mike Bostock","Mike Bostock",10,9,19,0,40
2013-03-14 15:16:52.000,"Mike Bostock","Mike Bostock",8,1,9,0,39
2013-03-14 06:32:17.000,"Mike Bostock","Mike Bostock",1,1,2,0,14
2013-03-14 06:21:23.000,"Mike Bostock","Mike Bostock",3603,3511,7114,0,28
2013-03-14 02:16:59.000,"Mike Bostock","Mike Bostock",69,83,152,0,32
2013-03-14 02:13:38.000,"Mike Bostock","Mike Bostock",180,192,372,0,33
2013-03-14 02:10:53.000,"Mike Bostock","Mike Bostock",831,877,1708,0,33
2013-03-13 20:58:41.000,"Mike Bostock","Mike Bostock",52,50,102,0,36
2013-03-13 20:13:09.000,"Mike Bostock","Mike Bostock",103,102,205,0,33
2013-03-13 20:06:33.000,"Mike Bostock","Mike Bostock",56,58,114,0,36
2013-03-13 18:50:05.000,"Mike Bostock","Mike Bostock",1,1,2,0,22
2013-03-13 18:46:32.000,"Mike Bostock","Mike Bostock",28,28,56,0,39
2013-03-13 17:56:33.000,"Mike Bostock","Mike Bostock",189,48,237,0,72
2013-03-13 17:47:58.000,"Mike Bostock","Mike Bostock",1,1,2,0,14
2013-03-13 17:26:15.000,"Jason Davies","Jason Davies",188,47,235,0,244
2013-03-13 15:53:00.000,"Mike Bostock","Mike Bostock",7,7,14,0,39
2013-03-12 18:55:39.000,"Jason Davies","Jason Davies",96,11,107,0,128
2013-03-13 09:08:02.000,"Mike Bostock","Mike Bostock",0,0,0,0,41
2013-03-13 09:03:00.000,"Mike Bostock","Mike Bostock",0,97,97,0,13
2013-03-13 09:01:49.000,"Mike Bostock","Mike Bostock",2,6,8,0,23
2013-03-13 08:59:36.000,"Mike Bostock","Mike Bostock",3,3,6,0,18
2013-03-13 08:56:00.000,"Mike Bostock","Mike Bostock",7776,7542,15318,0,33
2013-03-13 06:57:44.000,"Mike Bostock","Mike Bostock",193,98,291,0,24
2013-03-13 05:26:15.000,"Mike Bostock","Mike Bostock",1144,1024,2168,0,21
2013-03-13 05:01:56.000,"Mike Bostock","Mike Bostock",514,376,890,0,9
2013-03-13 04:31:15.000,"Mike Bostock","Mike Bostock",25,9,34,0,19
2013-03-13 04:01:49.000,"Mike Bostock","Mike Bostock",1354,1377,2731,0,6
2013-03-12 01:01:35.000,"Mike Bostock","Mike Bostock",57,28,85,0,783
2013-03-11 23:00:08.000,"Mike Bostock","Mike Bostock",2,2,4,0,92
2013-03-11 22:55:29.000,"Jason Davies","Jason Davies",2,2,4,0,161
2013-03-11 22:35:05.000,"Mike Bostock","Mike Bostock",5,5,10,0,14
2013-03-11 22:33:49.000,"Mike Bostock","Mike Bostock",23,7,30,0,76
2013-03-11 22:33:40.000,"Mike Bostock","Mike Bostock",419,402,821,1,36
2013-03-11 21:49:54.000,"Jason Davies","Jason Davies",23,7,30,0,34
2013-03-11 20:43:05.000,"Mike Bostock","Mike Bostock",859,676,1535,0,35
2013-03-11 19:58:00.000,"Mike Bostock","Mike Bostock",94,22,116,5,406
2013-03-11 17:56:20.000,"Mike Bostock","Mike Bostock",23,23,46,0,226
2013-03-07 23:14:58.000,"Mike Bostock","Mike Bostock",5,5,10,0,16
2013-03-07 23:07:40.000,"Mike Bostock","Mike Bostock",34,21,55,0,93
2013-03-07 23:03:56.000,"Jason Davies","Jason Davies",34,21,55,0,143
2013-03-07 20:05:49.000,"Mike Bostock","Mike Bostock",36,5,41,0,35
2013-03-07 17:54:19.000,"Mike Bostock","Mike Bostock",3,0,3,0,16
2013-03-07 17:53:00.000,"Mike Bostock","Mike Bostock",20,5,25,0,33
2013-03-07 15:56:58.000,"Mike Bostock","Mike Bostock",432,0,432,0,112
2013-03-07 15:45:00.000,"Mike Bostock","Mike Bostock",68,7,75,0,739
2013-03-07 15:12:47.000,"Dean Malmgren","Dean Malmgren",366,0,366,0,49
2013-03-07 15:05:51.000,"Dean Malmgren","Dean Malmgren",66,0,66,0,49
2013-03-06 16:54:13.000,"Jason Davies","Jason Davies",3,3,6,0,33
2013-03-06 14:56:54.000,"Jason Davies","Jason Davies",6,6,12,0,18
2013-03-06 13:46:42.000,"Jason Davies","Jason Davies",76,17,93,0,50
2013-03-05 15:29:45.000,"Jason Davies","Jason Davies",354,318,672,0,541
2013-03-06 05:08:48.000,"Mike Bostock","Mike Bostock",30,17,47,0,199
2013-03-06 04:56:30.000,"Mike Bostock","Mike Bostock",74,41,115,0,34
2013-03-06 04:55:52.000,"Mike Bostock","Mike Bostock",86,42,128,0,36
2013-03-06 04:54:58.000,"Mike Bostock","Mike Bostock",22,14,36,0,41
2013-03-06 04:50:19.000,"Mike Bostock","Mike Bostock",261,5,266,0,70
2013-03-06 04:49:22.000,"Mike Bostock","Mike Bostock",190,3,193,0,40
2013-03-06 04:46:22.000,"Mike Bostock","Mike Bostock",129,79,208,0,40
2013-03-06 04:45:54.000,"Mike Bostock","Mike Bostock",84,20,104,0,44
2013-03-06 04:45:25.000,"Mike Bostock","Mike Bostock",120,5,125,0,36
2013-03-06 04:44:20.000,"Mike Bostock","Mike Bostock",48,3,51,0,34
2013-03-06 04:43:51.000,"Mike Bostock","Mike Bostock",106,10,116,0,78
2013-03-06 04:42:53.000,"Mike Bostock","Mike Bostock",206,4,210,0,66
2013-03-06 04:41:35.000,"Mike Bostock","Mike Bostock",2,3,5,0,159
2013-03-06 03:28:39.000,"Mike Bostock","Mike Bostock",288,126,414,0,77
2013-03-05 18:07:34.000,"Mike Bostock","Mike Bostock",116,62,178,0,35
2013-03-05 17:40:00.000,"Mike Bostock","Mike Bostock",30,7,37,0,37
2013-03-05 16:59:23.000,"Mike Bostock","Mike Bostock",104,77,181,0,161
2013-03-02 23:09:02.000,"Mike Bostock","Mike Bostock",154,153,307,0,39
2013-03-04 23:20:44.000,"Jason Davies","Jason Davies",122,44,166,0,44
2013-03-04 15:32:33.000,"Jason Davies","Jason Davies",5,1,6,0,37
2013-03-04 15:08:38.000,"Jason Davies","Jason Davies",179,4,183,0,270
2013-03-03 22:13:01.000,"Mike Bostock","Mike Bostock",14,28,42,0,61
2013-03-03 18:28:58.000,"Mike Bostock","Mike Bostock",12,10,22,0,33
2013-03-03 17:11:21.000,"Mike Bostock","Mike Bostock",112,60,172,0,20
2013-03-03 17:07:10.000,"Mike Bostock","Mike Bostock",26,10,36,0,69
2013-03-03 17:06:48.000,"Mike Bostock","Mike Bostock",31,29,60,0,24
2013-03-03 16:57:06.000,"Mike Bostock","Mike Bostock",1,1,2,0,70
2013-03-03 11:19:04.000,"Jason Davies","Jason Davies",26,10,36,0,696
2013-03-02 23:09:02.000,"Mike Bostock","Mike Bostock",183,152,335,0,77
2013-03-02 22:57:21.000,"Mike Bostock","Mike Bostock",18,12,30,0,211
2013-03-02 22:46:45.000,"Mike Bostock","Mike Bostock",189,2,191,0,85
2013-03-02 21:56:04.000,"Mike Bostock","Mike Bostock",5,7,12,0,22
2013-03-02 21:54:44.000,"Mike Bostock","Mike Bostock",27,12,39,0,49
2013-03-02 21:49:50.000,"Mike Bostock","Mike Bostock",63,12,75,0,47
2013-03-02 18:32:22.000,"Mike Bostock","Mike Bostock",21,13,34,0,237
2013-03-01 22:12:24.000,"Mike Bostock","Mike Bostock",53,14,67,0,69
2013-03-01 21:59:47.000,"Mike Bostock","Mike Bostock",80,4,84,0,78
2013-02-26 23:48:45.000,"Mike Bostock","Mike Bostock",10,1,11,0,105
2013-02-18 12:50:11.000,"Jason Davies","Jason Davies",105,10,115,0,28
2013-02-23 12:48:25.000,"Thomas Fankhauser","Thomas Fankhauser",27,14,41,0,85
2013-02-22 17:40:01.000,"Thomas Fankhauser","Thomas Fankhauser",24,23,47,0,74
2013-02-22 17:18:28.000,"Thomas Fankhauser","Thomas Fankhauser",57,8,65,0,67
2013-02-22 16:42:51.000,"Thomas Fankhauser","Thomas Fankhauser",3,49,52,0,29
2013-02-19 03:12:57.000,"Mike Bostock","Mike Bostock",85,41,126,0,56
2013-02-18 13:05:42.000,"Jason Davies","Jason Davies",47,13,60,0,177
2013-02-14 19:30:35.000,"Mike Bostock","Mike Bostock",1,1,2,0,79
2013-02-14 19:17:57.000,"Calvin Metcalf","Calvin Metcalf",1,1,2,0,21
2013-02-14 18:09:35.000,"Mike Bostock","Mike Bostock",237,36,273,0,23
2013-02-11 19:56:32.000,"Mike Bostock","Mike Bostock",74,41,115,0,379
2013-02-11 14:35:14.000,"Thomas Fankhauser","Thomas Fankhauser",123,1,124,0,72
2013-02-10 21:14:24.000,"John Firebaugh","John Firebaugh",12,16,28,0,19
2013-02-09 22:42:04.000,"John Firebaugh","John Firebaugh",210,4,214,0,81
2013-02-07 14:37:29.000,"Ziggy Jonsson","Ziggy Jonsson",1,1,2,0,88
2013-02-07 13:13:00.000,"Ziggy Jonsson","Ziggy Jonsson",1,1,2,0,73
2013-02-06 19:04:42.000,"Mike Bostock","Mike Bostock",424,301,725,0,20
2013-02-06 18:59:09.000,"Mike Bostock","Mike Bostock",64,51,115,0,76
2013-02-06 18:58:29.000,"Mike Bostock","Mike Bostock",21,28,49,0,45
2013-02-06 18:57:55.000,"Mike Bostock","Mike Bostock",36,20,56,0,42
2013-02-06 18:57:30.000,"Mike Bostock","Mike Bostock",21,54,75,0,35
2013-02-06 18:57:05.000,"Mike Bostock","Mike Bostock",8,8,16,0,51
2013-02-06 18:56:37.000,"Mike Bostock","Mike Bostock",84,86,170,0,41
2013-02-06 18:52:35.000,"Mike Bostock","Mike Bostock",159,61,220,0,40
2013-02-06 18:52:10.000,"Mike Bostock","Mike Bostock",30,9,39,0,39
2013-02-06 18:48:13.000,"Mike Bostock","Mike Bostock",148,53,201,0,57
2013-02-06 18:25:19.000,"Mike Bostock","Mike Bostock",25,8,33,0,40
2013-02-06 18:18:52.000,"Mike Bostock","Mike Bostock",30,9,39,2,340
2013-02-06 17:47:47.000,"Mike Bostock","Mike Bostock",5,5,10,0,105
2013-02-06 16:55:05.000,"Mike Bostock","Mike Bostock",12,13,25,0,141
2013-02-06 16:51:20.000,"Mike Bostock","Mike Bostock",4,4,8,0,40
2013-02-06 16:49:25.000,"Mike Bostock","Mike Bostock",8,5,13,0,96
2013-01-22 08:54:00.000,"Jason Davies","Jason Davies",80,4,84,0,18
2013-02-01 13:20:05.000,"Jason Davies","Jason Davies",8,0,8,0,36
2013-02-01 19:06:29.000,"Mike Bostock","Mike Bostock",1,1,2,0,40
2013-02-01 18:57:37.000,"Mike Bostock","Mike Bostock",8,8,16,0,254
2013-02-01 18:30:48.000,"Mike Bostock","Mike Bostock",21,13,34,0,92
2013-02-01 17:58:24.000,"Mike Bostock","Mike Bostock",21,54,75,0,500
2013-02-01 16:51:47.000,"Jason Davies","Jason Davies",5,3,8,0,27
2013-02-01 16:09:12.000,"Mike Bostock","Mike Bostock",14,8,22,0,42
2013-01-31 23:11:40.000,"Mike Bostock","Mike Bostock",75,76,151,0,418
2013-01-17 09:47:24.000,"Jason Davies","Jason Davies",55,50,105,0,500
2013-01-31 13:23:54.000,"Jason Davies","Jason Davies",13,6,19,0,46
2013-01-24 17:07:38.000,"Mike Bostock","Mike Bostock",50,1483,1533,0,47
2013-01-23 23:38:44.000,"Mike Bostock","Mike Bostock",73,75,148,0,641
2013-01-23 20:26:09.000,"Mike Bostock","Mike Bostock",7,13,20,0,41
2013-01-23 18:25:35.000,"Mike Bostock","Mike Bostock",4,5,9,0,357
2013-01-22 02:52:15.000,"Mike Bostock","Mike Bostock",12,12,24,0,46
2013-01-20 19:50:18.000,"Mike Bostock","Mike Bostock",4,4,8,0,28
2013-01-16 18:21:29.000,"Mike Bostock","Mike Bostock",155,58,213,0,48
2013-01-15 18:23:30.000,"Mike Bostock","Mike Bostock",79,19,98,0,61
2013-01-15 18:01:05.000,"Mike Bostock","Mike Bostock",42,22,64,0,34
2013-01-13 19:02:16.000,"Mike Bostock","Mike Bostock",37,17,54,0,178
2013-01-11 00:42:56.000,"Mike Bostock","Mike Bostock",91,46,137,0,20
2013-01-11 00:41:55.000,"Mike Bostock","Mike Bostock",60,36,96,0,44
2013-01-11 00:41:08.000,"Mike Bostock","Mike Bostock",2,2,4,0,65
2013-01-08 23:42:47.000,"Mike Bostock","Mike Bostock",4,5,9,0,191
2013-01-08 23:32:21.000,"Mike Bostock","Mike Bostock",38,3,41,0,36
2013-01-08 23:18:59.000,"Mike Bostock","Mike Bostock",23,33,56,5,338
2013-01-07 14:16:37.000,"Isaac Z. Schlueter","Isaac Z. Schlueter",2,2,4,0,291
2013-01-05 01:45:43.000,"Jason Davies","Jason Davies",26,5,31,0,76
2013-01-04 22:29:21.000,"Jason Davies","Jason Davies",1,1,2,0,113
2013-01-01 23:52:50.000,"Mike Bostock","Mike Bostock",44,20,64,0,20
2013-01-01 23:52:03.000,"Mike Bostock","Mike Bostock",8,3,11,0,73
2013-01-01 23:50:17.000,"Mike Bostock","Mike Bostock",32,13,45,0,50
2012-12-29 13:05:27.000,"Jason Davies","Jason Davies",8,3,11,0,196
2012-12-28 17:19:30.000,"Mike Bostock","Mike Bostock",104,41,145,0,20
2012-12-28 17:18:41.000,"Mike Bostock","Mike Bostock",32,9,41,0,83
2012-12-28 17:18:15.000,"Mike Bostock","Mike Bostock",51,26,77,0,75
2012-12-28 16:51:49.000,"Nathan Vander Wilt","Nathan Vander Wilt",9,9,18,0,145
2012-12-28 16:37:24.000,"Nathan Vander Wilt","Nathan Vander Wilt",23,0,23,0,33
2012-12-27 13:09:50.000,"Jason Davies","Jason Davies",9,11,20,0,9
2012-12-27 12:57:52.000,"Jason Davies","Jason Davies",43,16,59,0,50
2012-12-25 02:18:27.000,"Jason Davies","Jason Davies",18,3,21,0,134
2012-12-21 17:18:07.000,"Mike Bostock","Mike Bostock",5,5,10,0,15
2012-12-21 06:47:10.000,"Mike Bostock","Mike Bostock",3187,1,3188,0,42
2012-12-21 01:21:49.000,"Mike Bostock","Mike Bostock",2,2,4,0,30
2012-12-20 23:37:09.000,"Mike Bostock","Mike Bostock",20,10,30,0,44
2012-12-20 23:33:13.000,"Mike Bostock","Mike Bostock",0,276,276,0,22
2012-12-20 23:31:59.000,"Mike Bostock","Mike Bostock",0,90,90,0,72
2012-12-20 23:31:38.000,"Mike Bostock","Mike Bostock",0,106,106,0,74
2012-12-20 23:19:05.000,"Mike Bostock","Mike Bostock",0,229,229,0,78
2012-12-20 22:39:56.000,"Mike Bostock","Mike Bostock",0,265,265,0,81
2012-12-20 22:37:10.000,"Mike Bostock","Mike Bostock",0,381,381,0,61
2012-12-20 22:13:45.000,"Mike Bostock","Mike Bostock",0,64,64,0,71
2012-12-20 20:55:26.000,"Mike Bostock","Mike Bostock",0,111,111,0,71
2012-12-20 20:44:12.000,"Mike Bostock","Mike Bostock",0,89,89,0,26
2012-12-20 20:43:45.000,"Mike Bostock","Mike Bostock",0,70,70,0,82
2012-12-20 18:29:10.000,"Mike Bostock","Mike Bostock",0,38,38,0,75
2012-12-20 16:15:20.000,"Mike Bostock","Mike Bostock",2,0,2,0,28
2012-12-20 06:02:30.000,"Mike Bostock","Mike Bostock",0,62,62,0,77
2012-12-20 06:01:07.000,"Mike Bostock","Mike Bostock",0,109,109,0,67
2012-12-20 05:35:52.000,"Mike Bostock","Mike Bostock",0,255,255,0,65
2012-12-20 01:07:27.000,"Mike Bostock","Mike Bostock",0,154,154,0,65
2012-12-20 01:01:55.000,"Mike Bostock","Mike Bostock",0,70,70,0,27
2012-12-20 00:52:08.000,"Mike Bostock","Mike Bostock",0,157,157,0,74
2012-12-20 00:51:52.000,"Mike Bostock","Mike Bostock",0,115,115,0,73
2012-12-20 00:50:07.000,"Mike Bostock","Mike Bostock",0,0,0,0,28
2012-12-20 00:43:06.000,"Mike Bostock","Mike Bostock",0,58,58,0,69
2012-12-20 00:32:54.000,"Mike Bostock","Mike Bostock",0,129,129,0,68
2012-12-20 00:31:52.000,"Mike Bostock","Mike Bostock",0,51,51,0,63
2012-12-20 00:30:40.000,"Mike Bostock","Mike Bostock",0,73,73,0,25
2012-12-20 00:27:09.000,"Mike Bostock","Mike Bostock",0,69,69,0,62
2012-12-19 23:40:31.000,"Mike Bostock","Mike Bostock",0,7483,7483,0,13
2012-12-19 23:39:42.000,"Mike Bostock","Mike Bostock",0,186,186,0,21
2012-12-19 23:38:37.000,"Mike Bostock","Mike Bostock",0,56,56,0,68
2012-12-19 23:38:01.000,"Mike Bostock","Mike Bostock",0,69,69,0,63
2012-12-19 23:29:47.000,"Mike Bostock","Mike Bostock",0,164,164,0,65
2012-12-19 23:22:16.000,"Mike Bostock","Mike Bostock",0,64,64,0,65
2012-12-19 23:14:50.000,"Mike Bostock","Mike Bostock",0,537,537,0,67
2012-12-19 23:11:57.000,"Mike Bostock","Mike Bostock",0,135,135,0,63
2012-12-19 23:10:27.000,"Mike Bostock","Mike Bostock",0,118,118,0,64
2012-12-19 22:47:14.000,"Mike Bostock","Mike Bostock",0,38,38,0,67
2012-12-19 22:33:19.000,"Mike Bostock","Mike Bostock",0,10794,10794,0,68
2012-12-19 22:31:38.000,"Mike Bostock","Mike Bostock",0,87,87,0,73
2012-12-19 20:55:44.000,"Mike Bostock","Mike Bostock",2,0,2,0,26
2012-12-19 20:53:05.000,"Mike Bostock","Mike Bostock",0,0,0,0,16
2012-12-19 20:50:07.000,"Mike Bostock","Mike Bostock",0,0,0,0,21
2012-12-19 20:41:01.000,"Mike Bostock","Mike Bostock",0,136,136,0,76
2012-12-19 20:21:03.000,"Mike Bostock","Mike Bostock",0,61,61,0,75
2012-12-19 20:20:14.000,"Mike Bostock","Mike Bostock",5,0,5,0,23
2012-12-19 19:52:49.000,"Mike Bostock","Mike Bostock",0,103,103,0,62
2012-12-19 19:51:53.000,"Mike Bostock","Mike Bostock",0,88,88,0,63
2012-12-19 19:51:07.000,"Mike Bostock","Mike Bostock",0,217,217,0,107
2012-12-19 19:50:25.000,"Mike Bostock","Mike Bostock",0,63,63,0,65
2012-12-19 19:47:54.000,"Mike Bostock","Mike Bostock",1,6,7,0,35
2012-12-19 19:47:01.000,"Mike Bostock","Mike Bostock",0,101,101,0,63
2012-12-19 19:46:48.000,"Mike Bostock","Mike Bostock",0,126,126,0,71
2012-12-19 19:45:21.000,"Mike Bostock","Mike Bostock",0,97,97,0,68
2012-12-19 19:43:54.000,"Mike Bostock","Mike Bostock",0,224,224,0,77
2012-12-19 19:43:31.000,"Mike Bostock","Mike Bostock",0,600,600,0,28
2012-12-19 19:42:54.000,"Mike Bostock","Mike Bostock",0,73,73,0,69
2012-12-19 19:42:16.000,"Mike Bostock","Mike Bostock",0,57,57,0,82
2012-12-19 19:41:51.000,"Mike Bostock","Mike Bostock",0,78,78,0,68
2012-12-19 19:41:26.000,"Mike Bostock","Mike Bostock",0,109,109,0,72
2012-12-19 19:41:07.000,"Mike Bostock","Mike Bostock",0,98,98,0,71
2012-12-19 19:38:08.000,"Mike Bostock","Mike Bostock",0,69,69,0,69
2012-12-19 19:23:19.000,"Mike Bostock","Mike Bostock",0,159,159,0,64
2012-12-19 19:22:13.000,"Mike Bostock","Mike Bostock",0,125,125,0,65
2012-12-19 19:20:29.000,"Mike Bostock","Mike Bostock",0,103,103,0,67
2012-12-19 19:19:31.000,"Mike Bostock","Mike Bostock",0,125,125,0,61
2012-12-19 19:18:43.000,"Mike Bostock","Mike Bostock",0,66,66,0,70
2012-12-19 19:16:04.000,"Mike Bostock","Mike Bostock",0,67,67,0,63
2012-12-19 19:14:19.000,"Mike Bostock","Mike Bostock",0,45,45,0,60
2012-12-19 19:08:26.000,"Mike Bostock","Mike Bostock",0,187,187,0,100
2012-12-19 19:07:26.000,"Mike Bostock","Mike Bostock",0,327,327,0,62
2012-12-19 19:06:25.000,"Mike Bostock","Mike Bostock",0,149,149,0,145
2012-12-19 19:05:38.000,"Mike Bostock","Mike Bostock",0,314,314,0,143
2012-12-19 19:04:28.000,"Mike Bostock","Mike Bostock",0,258,258,0,100
2012-12-19 18:54:39.000,"Mike Bostock","Mike Bostock",0,135,135,0,65
2012-12-19 18:54:01.000,"Mike Bostock","Mike Bostock",0,46,46,0,59
2012-12-19 18:53:16.000,"Mike Bostock","Mike Bostock",0,54,54,0,66
2012-12-19 18:49:10.000,"Mike Bostock","Mike Bostock",0,61,61,0,60
2012-12-19 18:48:42.000,"Mike Bostock","Mike Bostock",0,89,89,0,59
2012-12-19 18:45:26.000,"Mike Bostock","Mike Bostock",0,134,134,0,60
2012-12-19 18:43:25.000,"Mike Bostock","Mike Bostock",0,122,122,0,61
2012-12-19 18:38:01.000,"Mike Bostock","Mike Bostock",0,68,68,0,60
2012-12-19 18:32:17.000,"Mike Bostock","Mike Bostock",0,65,65,0,63
2012-12-19 18:31:50.000,"Mike Bostock","Mike Bostock",0,124,124,0,61
2012-12-19 18:31:30.000,"Mike Bostock","Mike Bostock",0,60,60,0,62
2012-12-19 18:31:10.000,"Mike Bostock","Mike Bostock",0,88,88,0,74
2012-12-19 18:30:32.000,"Mike Bostock","Mike Bostock",0,76,76,0,63
2012-12-19 18:29:22.000,"Mike Bostock","Mike Bostock",0,22,22,0,22
2012-12-19 18:29:00.000,"Mike Bostock","Mike Bostock",0,162,162,0,72
2012-12-19 18:21:29.000,"Mike Bostock","Mike Bostock",0,102,102,0,63
2012-12-19 18:12:32.000,"Mike Bostock","Mike Bostock",0,98,98,0,71
2012-12-19 18:11:39.000,"Mike Bostock","Mike Bostock",0,79,79,0,66
2012-12-19 18:11:12.000,"Mike Bostock","Mike Bostock",0,656,656,0,68
2012-12-19 18:10:18.000,"Mike Bostock","Mike Bostock",0,68,68,0,67
2012-12-19 18:09:03.000,"Mike Bostock","Mike Bostock",0,742,742,0,66
2012-12-19 04:38:45.000,"Mike Bostock","Mike Bostock",3,10,13,0,10
2012-12-19 04:36:32.000,"Mike Bostock","Mike Bostock",16,31,47,0,44
2012-12-19 04:21:22.000,"Mike Bostock","Mike Bostock",24,3,27,0,34
2012-12-19 01:36:43.000,"Mike Bostock","Mike Bostock",17,6,23,0,114
2012-12-18 19:38:12.000,"Mike Bostock","Mike Bostock",20,10,30,0,92
2012-12-18 02:32:06.000,"Mike Bostock","Mike Bostock",3,3,6,0,43
2012-12-17 22:57:21.000,"Jason Davies","Jason Davies",36,7,43,0,296
2012-12-17 17:44:55.000,"Jason Davies","Jason Davies",5,5,10,0,24
2012-12-17 21:40:41.000,"Mike Bostock","Mike Bostock",7,8,15,0,45
2012-12-17 11:23:42.000,"Jason Davies","Jason Davies",9,1,10,0,29
2012-12-16 23:57:39.000,"Jason Davies","Jason Davies",54,54,108,0,192
2012-12-15 22:23:05.000,"Mike Bostock","Mike Bostock",3,2,5,0,41
2012-12-15 21:25:36.000,"Mike Bostock","Mike Bostock",9,18,27,0,33
2012-12-15 21:07:29.000,"Mike Bostock","Mike Bostock",14,34,48,0,48
2012-12-15 21:02:08.000,"Mike Bostock","Mike Bostock",0,21,21,0,19
2012-12-15 21:01:53.000,"Mike Bostock","Mike Bostock",3,3,6,0,25
2012-12-15 20:59:55.000,"Mike Bostock","Mike Bostock",83,103,186,0,39
2012-12-15 20:48:22.000,"Mike Bostock","Mike Bostock",34,45,79,0,36
2012-12-15 20:42:00.000,"Mike Bostock","Mike Bostock",612,634,1246,0,107
2012-12-15 14:40:53.000,"Jason Davies","Jason Davies",8,7,15,0,32
2012-12-15 02:35:02.000,"Mike Bostock","Mike Bostock",66,75,141,0,43
2012-12-14 13:26:43.000,"Jason Davies","Jason Davies",3,3,6,0,12
2012-12-14 01:12:10.000,"Jason Davies","Jason Davies",14,5,19,0,64
2012-12-14 01:29:46.000,"Jason Davies","Jason Davies",66,17,83,0,44
2012-12-13 21:55:00.000,"Jason Davies","Jason Davies",28,17,45,0,48
2012-12-14 00:05:59.000,"Mike Bostock","Mike Bostock",9,14,23,0,30
2012-12-13 19:20:47.000,"Jason Davies","Jason Davies",5,5,10,0,86
2012-12-13 19:11:38.000,"Jason Davies","Jason Davies",3,3,6,0,46
2012-12-13 19:09:15.000,"Jason Davies","Jason Davies",7,3,10,0,46
2012-12-13 18:59:59.000,"Jason Davies","Jason Davies",3,3,6,0,162
2012-12-13 17:50:37.000,"Mike Bostock","Mike Bostock",42,30,72,0,33
2012-12-13 17:34:02.000,"Mike Bostock","Mike Bostock",5,5,10,0,21
2012-12-13 16:01:11.000,"Jason Davies","Jason Davies",0,1,1,0,12
2012-12-13 15:59:45.000,"Jason Davies","Jason Davies",49,31,80,0,28
2012-12-13 15:34:55.000,"Jason Davies","Jason Davies",6,6,12,0,78
2012-12-13 14:53:46.000,"Jason Davies","Jason Davies",140,124,264,0,21
2012-12-13 13:51:46.000,"Jason Davies","Jason Davies",1,3,4,0,18
2012-12-13 13:29:17.000,"Jason Davies","Jason Davies",86,19,105,0,95
2012-12-13 13:10:44.000,"Jason Davies","Jason Davies",11,10,21,0,39
2012-12-13 13:00:51.000,"Jason Davies","Jason Davies",39,9,48,0,120
2012-12-13 12:48:36.000,"Jason Davies","Jason Davies",30,12,42,0,331
2012-12-13 12:22:41.000,"Jason Davies","Jason Davies",134,388,522,0,44
2012-12-13 10:58:40.000,"Jason Davies","Jason Davies",53,23,76,0,21
2012-12-13 10:57:38.000,"Jason Davies","Jason Davies",16,3,19,0,121
2012-12-13 05:22:54.000,"Mike Bostock","Mike Bostock",22,15,37,0,28
2012-12-13 03:02:09.000,"Mike Bostock","Mike Bostock",11,11,22,0,36
2012-12-13 02:54:10.000,"Mike Bostock","Mike Bostock",12,14,26,0,38
2012-12-13 02:39:50.000,"Jason Davies","Jason Davies",9,5,14,0,88
2012-12-12 22:58:01.000,"Jason Davies","Jason Davies",262,155,417,0,31
2012-12-13 01:15:05.000,"Mike Bostock","Mike Bostock",83,50,133,0,38
2012-12-13 00:54:58.000,"Mike Bostock","Mike Bostock",35,35,70,0,108
2012-12-13 00:42:07.000,"Mike Bostock","Mike Bostock",91,85,176,0,35
2012-12-13 00:18:39.000,"Mike Bostock","Mike Bostock",11,4,15,0,26
2012-12-13 00:17:02.000,"Mike Bostock","Mike Bostock",158,222,380,0,49
2012-12-12 23:52:54.000,"Mike Bostock","Mike Bostock",4,1,5,0,30
2012-12-12 23:48:37.000,"Mike Bostock","Mike Bostock",86,65,151,0,40
2012-12-12 23:30:30.000,"Mike Bostock","Mike Bostock",3,3,6,0,39
2012-12-12 23:23:55.000,"Mike Bostock","Mike Bostock",4,7,11,0,98
2012-12-12 23:16:49.000,"Mike Bostock","Mike Bostock",1,23,24,0,66
2012-12-12 23:07:09.000,"Mike Bostock","Mike Bostock",3,3,6,0,18
2012-12-12 22:59:51.000,"Mike Bostock","Mike Bostock",30,34,64,0,22
2012-12-12 22:57:24.000,"Mike Bostock","Mike Bostock",94,124,218,0,40
2012-12-12 22:19:52.000,"Mike Bostock","Mike Bostock",12,15,27,0,32
2012-12-12 22:13:03.000,"Mike Bostock","Mike Bostock",484,509,993,0,73
2012-12-12 21:56:41.000,"Mike Bostock","Mike Bostock",328,72,400,0,28
2012-12-12 21:33:59.000,"Jason Davies","Jason Davies",543,573,1116,0,98
2012-12-12 19:32:08.000,"Mike Bostock","Mike Bostock",84,68,152,0,21
2012-12-12 18:40:03.000,"Mike Bostock","Mike Bostock",1,1,2,0,38
2012-12-12 18:38:20.000,"Mike Bostock","Mike Bostock",15,10,25,0,42
2012-12-12 18:35:14.000,"Mike Bostock","Mike Bostock",55,44,99,0,43
2012-12-12 18:17:52.000,"Mike Bostock","Mike Bostock",76,23,99,0,36
2012-12-12 18:16:27.000,"Mike Bostock","Mike Bostock",80,0,80,0,31
2012-12-12 17:09:21.000,"Mike Bostock","Mike Bostock",159,4,163,0,77
2012-12-12 13:51:10.000,"Jason Davies","Jason Davies",7,7,14,0,19
2012-12-12 12:08:50.000,"Jason Davies","Jason Davies",5,5,10,0,19
2012-12-12 12:00:29.000,"Jason Davies","Jason Davies",4,3,7,0,167
2012-12-12 11:25:29.000,"Jason Davies","Jason Davies",28,22,50,0,48
2012-12-12 10:20:49.000,"Jason Davies","Jason Davies",36,57,93,0,137
2012-12-12 09:37:33.000,"Jason Davies","Jason Davies",18,17,35,0,32
2012-12-12 09:25:22.000,"Jason Davies","Jason Davies",191,179,370,0,24
2012-12-12 09:19:58.000,"Jason Davies","Jason Davies",23,31,54,0,34
2012-12-12 08:43:32.000,"Jason Davies","Jason Davies",13,6,19,0,25
2012-12-12 05:55:40.000,"Mike Bostock","Mike Bostock",10,4,14,0,11
2012-12-12 05:50:57.000,"Mike Bostock","Mike Bostock",90,90,180,0,24
2012-12-12 05:31:12.000,"Mike Bostock","Mike Bostock",13,4,17,0,11
2012-12-12 05:22:50.000,"Mike Bostock","Mike Bostock",23,17,40,0,171
2012-12-12 05:04:34.000,"Mike Bostock","Mike Bostock",29,35,64,0,25
2012-12-12 00:11:08.000,"Jason Davies","Jason Davies",45,83,128,0,130
2012-12-11 21:58:45.000,"Jason Davies","Jason Davies",77,80,157,0,114
2012-12-11 20:40:58.000,"Jason Davies","Jason Davies",738,653,1391,0,50
2012-12-11 19:55:01.000,"Mike Bostock","Mike Bostock",95,138,233,0,45
2012-12-11 19:26:09.000,"Mike Bostock","Mike Bostock",16,4,20,0,33
2012-12-11 19:16:45.000,"Mike Bostock","Mike Bostock",2,2,4,0,13
2012-12-11 19:03:41.000,"Mike Bostock","Mike Bostock",62,30,92,0,153
2012-12-11 18:21:44.000,"Mike Bostock","Mike Bostock",88,63,151,0,48
2012-12-11 00:23:27.000,"Jason Davies","Jason Davies",708,674,1382,0,46
2012-12-10 23:41:13.000,"Mike Bostock","Mike Bostock",17,17,34,0,35
2012-12-10 21:23:27.000,"Jason Davies","Jason Davies",94,92,186,0,34
2012-12-10 22:55:20.000,"Mike Bostock","Mike Bostock",10,8,18,0,31
2012-12-10 22:49:20.000,"Mike Bostock","Mike Bostock",126,116,242,0,46
2012-12-10 20:04:58.000,"Mike Bostock","Mike Bostock",71,103,174,0,64
2012-12-10 16:40:29.000,"Mike Bostock","Mike Bostock",62,5,67,0,69
2012-12-10 11:26:37.000,"Jason Davies","Jason Davies",62,5,67,0,23
2012-12-09 21:44:05.000,"Mike Bostock","Mike Bostock",2,4,6,0,25
2012-12-09 20:46:14.000,"Jason Davies","Jason Davies",7,4,11,0,47
2012-12-09 20:32:01.000,"Jason Davies","Jason Davies",30,6,36,0,35
2012-12-08 14:48:16.000,"Jason Davies","Jason Davies",208,4,212,0,27
2012-12-07 18:41:53.000,"Jason Davies","Mike Bostock",7,13,20,0,9
2012-12-06 17:15:47.000,"Jason Davies","Mike Bostock",272,27,299,0,113
2012-12-08 16:26:39.000,"Mike Bostock","Mike Bostock",5,5,10,0,51
2012-12-08 14:48:54.000,"Jason Davies","Jason Davies",5,5,10,0,7
2012-12-07 20:44:21.000,"Mike Bostock","Mike Bostock",20,3,23,0,27
2012-12-07 03:50:36.000,"Mike Bostock","Mike Bostock",28,4,32,0,32
2012-12-06 17:14:58.000,"Mike Bostock","Mike Bostock",13,13,26,0,73
2012-12-06 17:13:53.000,"Mike Bostock","Mike Bostock",211,233,444,0,69
2012-12-06 16:45:36.000,"Mike Bostock","Mike Bostock",6,6,12,0,88
2012-12-06 10:40:06.000,"Jason Davies","Jason Davies",22,11,33,0,50
2012-12-06 09:58:38.000,"Jason Davies","Jason Davies",1,1,2,0,31
2012-12-06 09:44:18.000,"Jason Davies","Jason Davies",73,105,178,0,9
2012-12-06 09:17:53.000,"Jason Davies","Jason Davies",110,130,240,0,30
2012-12-06 00:56:24.000,"Jason Davies","Jason Davies",40,29,69,0,26
2012-12-06 00:39:57.000,"Jason Davies","Jason Davies",35,15,50,0,46
2012-12-05 20:58:43.000,"Jason Davies","Jason Davies",44,72,116,0,52
2012-12-05 20:35:50.000,"Jason Davies","Jason Davies",61,45,106,0,78
2012-12-05 20:12:45.000,"Mike Bostock","Mike Bostock",3,3,6,1,17
2012-12-05 20:04:18.000,"Jason Davies","Jason Davies",70,21,91,0,29
2012-12-05 18:55:24.000,"Jason Davies","Jason Davies",107,83,190,0,39
2012-12-05 18:39:57.000,"Jason Davies","Jason Davies",72,50,122,0,203
2012-12-05 18:16:35.000,"Jason Davies","Jason Davies",18,8,26,0,344
2012-12-05 17:48:24.000,"Mike Bostock","Mike Bostock",8,18,26,0,41
2012-11-29 09:25:37.000,"Jason Davies","Mike Bostock",36,0,36,0,159
2012-11-22 20:14:23.000,"Jason Davies","Mike Bostock",380,235,615,0,219
2012-11-22 19:34:57.000,"Jason Davies","Mike Bostock",20,3,23,0,37
2012-11-21 12:02:10.000,"Jason Davies","Mike Bostock",4,4,8,0,100
2012-11-21 09:55:00.000,"Jason Davies","Mike Bostock",29,12,41,0,37
2012-12-04 21:00:41.000,"Jason Davies","Jason Davies",4,4,8,0,22
2012-12-04 20:56:14.000,"Jason Davies","Jason Davies",43,7,50,0,193
2012-11-30 18:25:12.000,"Mike Bostock","Mike Bostock",24,21,45,0,53
2012-11-26 23:47:06.000,"Mike Bostock","Mike Bostock",6,6,12,0,40
2012-11-21 17:35:15.000,"Jason Davies","Jason Davies",7,4,11,0,18
2012-11-21 15:56:46.000,"Jason Davies","Jason Davies",30,22,52,0,37
2012-11-21 15:22:57.000,"Jason Davies","Jason Davies",170,117,287,0,135
2012-11-21 00:54:32.000,"Jason Davies","Jason Davies",10,3,13,0,31
2012-11-21 00:36:25.000,"Jason Davies","Jason Davies",9,7,16,0,25
2012-11-20 18:15:11.000,"Jason Davies","Jason Davies",177,133,310,0,619
2012-11-18 15:53:29.000,"Jason Davies","Jason Davies",208,97,305,0,21
2012-11-18 20:05:33.000,"Jason Davies","Jason Davies",13,54,67,0,9
2012-11-18 18:21:55.000,"Mike Bostock","Mike Bostock",30,25,55,0,64
2012-11-18 18:16:01.000,"Mike Bostock","Mike Bostock",1,34,35,0,31
2012-11-18 18:15:13.000,"Mike Bostock","Mike Bostock",18,20,38,0,30
2012-11-18 18:12:41.000,"Mike Bostock","Mike Bostock",42,177,219,0,90
2012-11-18 17:12:10.000,"Mike Bostock","Mike Bostock",37,47,84,0,27
2012-11-18 17:06:38.000,"Mike Bostock","Mike Bostock",6,22,28,0,11
2012-11-18 17:01:00.000,"Mike Bostock","Mike Bostock",5,11,16,0,38
2012-11-18 16:46:43.000,"Mike Bostock","Mike Bostock",8,8,16,0,9
2012-11-18 16:40:57.000,"Mike Bostock","Mike Bostock",8,108,116,0,650
2012-11-18 16:29:37.000,"Mike Bostock","Mike Bostock",94,106,200,0,38
2012-11-18 15:40:10.000,"Mike Bostock","Mike Bostock",90,95,185,0,20
2012-11-17 17:56:07.000,"Jason Davies","Jason Davies",30,25,55,0,49
2012-11-16 09:34:46.000,"Jason Davies","Jason Davies",3,1,4,0,115
2012-11-16 09:08:46.000,"Jason Davies","Jason Davies",6,0,6,0,33
2012-11-15 23:27:14.000,"Jason Davies","Jason Davies",21,6,27,0,37
2012-11-15 20:33:31.000,"Jason Davies","Jason Davies",15,16,31,0,44
2012-11-15 16:06:17.000,"Jason Davies","Jason Davies",6,5,11,0,48
2012-11-14 23:23:54.000,"Jason Davies","Jason Davies",30,21,51,0,349
2012-11-14 16:19:24.000,"Jason Davies","Jason Davies",3,3,6,0,7
2012-11-14 14:51:11.000,"Jason Davies","Jason Davies",37,26,63,0,43
2012-11-14 14:07:33.000,"Jason Davies","Jason Davies",6,4,10,0,48
2012-11-14 13:07:19.000,"Jason Davies","Jason Davies",15,5,20,0,45
2012-11-14 12:44:29.000,"Jason Davies","Jason Davies",29,8,37,0,43
2012-11-14 11:49:47.000,"Jason Davies","Jason Davies",26,3,29,0,34
2012-11-13 22:51:56.000,"Jason Davies","Jason Davies",11,15,26,0,24
2012-11-13 22:50:52.000,"Jason Davies","Jason Davies",3,3,6,0,79
2012-11-13 13:28:46.000,"Jason Davies","Jason Davies",3,3,6,0,42
2012-11-13 13:21:28.000,"Jason Davies","Jason Davies",11,22,33,0,9
2012-11-13 13:07:27.000,"Jason Davies","Jason Davies",7,6,13,0,146
2012-11-11 19:23:35.000,"Mike Bostock","Mike Bostock",4,4,8,0,9
2012-11-11 19:22:44.000,"Mike Bostock","Mike Bostock",4,7634,7638,0,31
2012-11-11 19:20:15.000,"Mike Bostock","Mike Bostock",1558,1882,3440,0,17
2012-11-11 17:44:40.000,"Mike Bostock","Mike Bostock",57,100,157,0,16
2012-11-11 17:28:41.000,"Mike Bostock","Mike Bostock",23,9,32,0,74
2012-11-11 17:25:53.000,"Mike Bostock","Mike Bostock",82,41,123,0,93
2012-11-10 23:24:27.000,"Jason Davies","Jason Davies",7,7,14,0,26
2012-11-10 23:23:06.000,"Jason Davies","Jason Davies",3,3,6,0,51
2012-11-10 21:57:56.000,"Jason Davies","Jason Davies",17,12,29,0,76
2012-11-10 18:23:57.000,"Jason Davies","Jason Davies",74,38,112,0,148
2012-11-02 23:47:18.000,"Jason Davies","Jason Davies",23,9,32,0,63
2012-11-02 21:15:35.000,"Mike Bostock","Mike Bostock",9,16,25,0,43
2012-11-02 19:50:20.000,"Mike Bostock","Mike Bostock",4835,4812,9647,0,20
2012-10-31 09:12:26.000,"Jason Davies","Jason Davies",3,3,6,0,9
2012-10-31 01:00:57.000,"Jason Davies","Jason Davies",14,14,28,0,104
2012-10-30 21:42:05.000,"Mike Bostock","Mike Bostock",95,60,155,0,218
2012-10-30 02:49:35.000,"Mike Bostock","Mike Bostock",33,23,56,0,33
2012-10-29 17:17:35.000,"Mike Bostock","Mike Bostock",13,4,17,0,99
2012-10-29 16:42:33.000,"Mike Bostock","Mike Bostock",0,14,14,0,22
2012-10-29 16:35:01.000,"Mike Bostock","Mike Bostock",150,40,190,0,103
2012-10-29 16:23:18.000,"Mike Bostock","Mike Bostock",100,70,170,0,65
2012-10-29 16:07:00.000,"Mike Bostock","Mike Bostock",60,45,105,1,159
2012-10-29 15:50:22.000,"Mike Bostock","Mike Bostock",25,26,51,0,136
2012-10-27 01:28:27.000,"Mike Bostock","Mike Bostock",15,11,26,0,33
2012-10-25 18:38:23.000,"Mike Bostock","Mike Bostock",70,6,76,0,91
2012-10-25 18:29:24.000,"Jason Davies","Jason Davies",70,6,76,0,39
2012-10-19 06:19:32.000,"Mike Bostock","Mike Bostock",50,58,108,0,498
2012-10-17 05:51:11.000,"Mike Bostock","Mike Bostock",12,10,22,0,46
2012-10-17 01:17:35.000,"Mike Bostock","Mike Bostock",80,96,176,0,29
2012-10-17 00:58:37.000,"Mike Bostock","Mike Bostock",89,88,177,0,22
2012-10-17 00:40:46.000,"Mike Bostock","Mike Bostock",141,108,249,0,653
2012-10-16 22:02:08.000,"Mike Bostock","Mike Bostock",8,12,20,0,298
2012-10-16 21:14:28.000,"Mike Bostock","Mike Bostock",3,3,6,0,42
2012-10-15 16:13:40.000,"Mike Bostock","Mike Bostock",23,4,27,0,267
2012-10-12 01:10:26.000,"Mike Bostock","Mike Bostock",35,8,43,0,41
2012-10-12 00:34:17.000,"Mike Bostock","Mike Bostock",2781,3766,6547,0,27
2012-10-11 22:50:52.000,"Mike Bostock","Mike Bostock",31,35,66,0,23
2012-10-11 22:39:59.000,"Mike Bostock","Mike Bostock",65,109,174,0,50
2012-10-11 20:32:44.000,"Mike Bostock","Mike Bostock",221,170,391,0,478
2012-10-08 05:00:06.000,"Mike Bostock","Mike Bostock",86,77,163,0,50
2012-10-07 00:40:37.000,"Mike Bostock","Mike Bostock",128,31,159,0,39
2012-10-06 21:19:05.000,"Mike Bostock","Mike Bostock",106,40,146,0,86
2012-10-06 15:11:07.000,"Mike Bostock","Mike Bostock",1,1,2,0,20
2012-10-06 15:08:59.000,"Mike Bostock","Mike Bostock",198,42,240,0,71
2012-10-06 10:17:46.000,"Jason Davies","Jason Davies",28,42,70,0,9
2012-10-06 10:11:47.000,"Jason Davies","Jason Davies",212,42,254,0,69
2012-10-06 05:33:03.000,"Mike Bostock","Mike Bostock",4,4,8,0,25
2012-10-06 02:46:05.000,"Mike Bostock","Mike Bostock",138,138,276,0,107
2012-10-06 01:15:19.000,"Mike Bostock","Mike Bostock",208,62,270,0,71
2012-10-06 01:05:59.000,"Mike Bostock","Mike Bostock",37,48,85,0,42
2012-10-06 01:05:41.000,"Jason Davies","Jason Davies",29,28,57,0,39
2012-10-06 00:59:50.000,"Mike Bostock","Mike Bostock",2,8,10,0,39
2012-10-06 00:58:59.000,"Mike Bostock","Mike Bostock",4,5,9,0,21
2012-10-06 00:58:19.000,"Mike Bostock","Mike Bostock",4,75,79,0,16
2012-10-06 00:57:39.000,"Mike Bostock","Mike Bostock",1,4,5,0,26
2012-10-06 00:56:49.000,"Mike Bostock","Mike Bostock",333,355,688,0,53
2012-10-06 00:54:21.000,"Jason Davies","Jason Davies",190,60,250,0,121
2012-10-06 00:46:05.000,"Mike Bostock","Mike Bostock",4,127,131,0,23
2012-10-06 00:44:48.000,"Mike Bostock","Mike Bostock",3,133,136,0,64
2012-10-06 00:35:13.000,"Mike Bostock","Mike Bostock",2325,1359,3684,0,64
2012-10-06 00:29:56.000,"Mike Bostock","Mike Bostock",388,318,706,0,44
2012-10-06 00:12:17.000,"Mike Bostock","Mike Bostock",36,20,56,0,38
2012-10-06 00:02:12.000,"Jason Davies","Jason Davies",19,4,23,0,23
2012-10-05 22:50:34.000,"Mike Bostock","Mike Bostock",14,14,28,0,95
2012-10-05 22:46:57.000,"Mike Bostock","Mike Bostock",2,2,4,0,17
2012-10-05 20:00:16.000,"Mike Bostock","Mike Bostock",311,247,558,0,2347
2012-10-05 07:20:56.000,"Mike Bostock","Mike Bostock",19,10,29,0,98
2012-10-04 18:14:16.000,"Mike Bostock","Mike Bostock",109,90,199,0,21
2012-10-04 18:11:24.000,"Mike Bostock","Mike Bostock",23,35,58,0,252
2012-10-04 10:49:15.000,"Jason Davies","Jason Davies",19,10,29,0,1141
2012-10-03 22:53:26.000,"Mike Bostock","Mike Bostock",82,20,102,0,103
2012-10-03 21:49:50.000,"Jason Davies","Jason Davies",82,20,102,0,184
2012-10-03 09:23:48.000,"Jason Davies","Jason Davies",5,5,10,0,270
2012-10-02 23:58:37.000,"Jason Davies","Jason Davies",16,13,29,0,147
2012-10-02 20:12:38.000,"Jason Davies","Jason Davies",6,6,12,0,50
2012-10-02 18:52:53.000,"Jason Davies","Jason Davies",8,4,12,0,69
2012-10-02 17:49:09.000,"Jason Davies","Jason Davies",10,9,19,0,114
2012-10-02 15:53:29.000,"Jason Davies","Jason Davies",9,10,19,0,327
2012-10-02 14:28:59.000,"Jason Davies","Jason Davies",11,6,17,0,92
2012-10-02 14:28:19.000,"Mike Bostock","Mike Bostock",12,7,19,0,111
2012-10-02 14:23:37.000,"Jason Davies","Jason Davies",6,11,17,0,92
2012-10-02 14:19:31.000,"Mike Bostock","Mike Bostock",7,12,19,0,39
2012-10-02 13:38:46.000,"Jason Davies","Jason Davies",4,52,56,0,19
2012-10-02 12:47:20.000,"Jason Davies","Jason Davies",17,12,29,0,31
2012-10-02 12:41:45.000,"Jason Davies","Jason Davies",4,17,21,0,19
2012-10-02 11:14:18.000,"Jason Davies","Jason Davies",75,57,132,0,34
2012-10-02 10:45:51.000,"Jason Davies","Jason Davies",614,426,1040,0,129
2012-10-01 23:48:51.000,"Jason Davies","Jason Davies",343,426,769,0,50
2012-10-02 06:45:14.000,"Mike Bostock","Mike Bostock",5,5,10,0,31
2012-10-02 06:39:17.000,"Mike Bostock","Mike Bostock",131,82,213,0,89
2012-10-02 05:58:19.000,"Mike Bostock","Mike Bostock",4,4,8,0,19
2012-10-02 05:50:18.000,"Mike Bostock","Mike Bostock",276,346,622,0,21
2012-10-02 04:39:38.000,"Mike Bostock","Mike Bostock",99,0,99,0,28
2012-10-02 02:20:14.000,"Mike Bostock","Mike Bostock",154,38,192,0,44
2012-10-01 21:57:39.000,"Jason Davies","Jason Davies",98,19,117,0,51
2012-09-29 23:54:07.000,"Mike Bostock","Mike Bostock",12,8,20,0,38
2012-09-29 23:52:37.000,"Mike Bostock","Mike Bostock",12,12,24,0,27
2012-09-29 23:50:01.000,"Jason Davies","Jason Davies",38,54,92,0,127
2012-09-29 22:09:12.000,"Mike Bostock","Mike Bostock",64,65,129,0,35
2012-09-29 21:55:30.000,"Mike Bostock","Mike Bostock",56,54,110,0,113
2012-09-29 18:20:45.000,"Jason Davies","Jason Davies",20,23,43,0,31
2012-09-29 15:01:39.000,"Jason Davies","Jason Davies",183,176,359,0,306
2012-09-29 14:40:10.000,"Jason Davies","Jason Davies",66,66,132,0,262
2012-09-29 14:12:42.000,"Jason Davies","Jason Davies",5,3,8,0,20
2012-09-29 14:09:58.000,"Jason Davies","Jason Davies",7,11,18,0,9
2012-09-29 12:15:17.000,"Jason Davies","Jason Davies",18,21,39,0,202
2012-09-29 11:24:28.000,"Jason Davies","Jason Davies",423,308,731,0,32
2012-09-29 00:16:53.000,"Mike Bostock","Mike Bostock",86,55,141,0,30
2012-09-28 23:47:13.000,"Mike Bostock","Mike Bostock",30,3,33,0,41
2012-09-28 23:41:55.000,"Mike Bostock","Mike Bostock",3,0,3,0,48
2012-09-28 23:17:54.000,"Mike Bostock","Mike Bostock",54,53,107,0,24
2012-09-28 20:25:29.000,"Jason Davies","Jason Davies",457,101,558,0,38
2012-09-28 16:53:49.000,"Mike Bostock","Mike Bostock",14,12,26,0,94
2012-09-28 09:15:06.000,"Jason Davies","Jason Davies",6,6,12,0,210
2012-09-28 08:57:03.000,"Jason Davies","Jason Davies",14,12,26,0,410
2012-09-27 23:29:36.000,"Mike Bostock","Mike Bostock",6,6,12,0,27
2012-09-27 23:21:51.000,"Mike Bostock","Mike Bostock",7,7,14,0,11
2012-09-27 23:14:05.000,"Mike Bostock","Mike Bostock",46,40,86,0,111
2012-09-27 20:39:23.000,"Mike Bostock","Mike Bostock",52,46,98,0,39
2012-09-27 20:13:01.000,"Mike Bostock","Mike Bostock",5,5,10,0,27
2012-09-27 20:11:20.000,"Mike Bostock","Mike Bostock",38,32,70,0,44
2012-09-27 05:19:56.000,"Mike Bostock","Mike Bostock",35,42,77,0,23
2012-09-27 05:01:42.000,"Mike Bostock","Mike Bostock",6,1,7,0,88
2012-09-27 01:33:32.000,"Mike Bostock","Mike Bostock",10,8,18,0,21
2012-09-27 01:25:55.000,"Mike Bostock","Mike Bostock",0,0,0,0,78
2012-09-26 20:23:32.000,"Mike Bostock","Mike Bostock",15,9,24,0,26
2012-09-26 19:51:49.000,"Mike Bostock","Mike Bostock",5,1,6,0,37
2012-09-26 19:40:49.000,"Mike Bostock","Mike Bostock",55,38,93,0,30
2012-09-26 19:34:39.000,"Mike Bostock","Mike Bostock",3,2,5,0,32
2012-09-26 18:30:36.000,"Jason Davies","Mike Bostock",10,12,22,0,9
2012-09-26 17:29:44.000,"Jason Davies","Mike Bostock",20,9,29,0,39
2012-09-26 18:30:36.000,"Jason Davies","Jason Davies",10,12,22,0,9
2012-09-26 17:29:44.000,"Jason Davies","Jason Davies",20,9,29,0,39
2012-09-26 15:58:33.000,"Mike Bostock","Mike Bostock",176,76,252,0,102
2012-09-26 14:57:55.000,"Jason Davies","Jason Davies",8,8,16,0,31
2012-09-26 14:47:21.000,"Jason Davies","Jason Davies",3,3,6,0,225
2012-09-26 14:30:40.000,"Jason Davies","Jason Davies",10,10,20,0,285
2012-09-26 14:16:03.000,"Jason Davies","Jason Davies",19,34,53,0,9
2012-09-26 14:14:13.000,"Jason Davies","Jason Davies",6,6,12,0,49
2012-09-26 13:35:11.000,"Jason Davies","Jason Davies",38,25,63,0,78
2012-09-26 12:18:04.000,"Jason Davies","Jason Davies",23,12,35,0,247
2012-09-26 12:07:00.000,"Jason Davies","Jason Davies",125,59,184,0,31
2012-09-26 10:01:32.000,"Jason Davies","Jason Davies",6,6,12,0,19
2012-09-26 09:59:49.000,"Jason Davies","Jason Davies",6,6,12,0,19
2012-09-26 09:51:47.000,"Jason Davies","Jason Davies",13,13,26,0,65
2012-09-26 09:29:01.000,"Jason Davies","Jason Davies",35,36,71,0,27
2012-09-26 09:23:58.000,"Jason Davies","Jason Davies",13,10,23,0,19
2012-09-26 09:14:09.000,"Jason Davies","Jason Davies",41,18,59,0,35
2012-09-26 01:15:11.000,"Mike Bostock","Mike Bostock",5,9,14,0,18
2012-09-26 00:35:02.000,"Jason Davies","Jason Davies",17,7,24,0,23
2012-09-26 00:24:07.000,"Jason Davies","Jason Davies",56,6,62,0,256
2012-09-25 23:46:29.000,"Mike Bostock","Mike Bostock",6,6,12,0,26
2012-09-25 23:36:07.000,"Mike Bostock","Mike Bostock",21,21,42,0,24
2012-09-25 23:29:29.000,"Mike Bostock","Mike Bostock",32,30,62,0,78
2012-09-25 23:19:50.000,"Mike Bostock","Mike Bostock",93,24,117,0,78
2012-09-25 23:17:17.000,"Jason Davies","Jason Davies",12,12,24,0,22
2012-09-25 22:57:13.000,"Jason Davies","Jason Davies",9,8,17,0,9
2012-09-25 22:52:25.000,"Jason Davies","Jason Davies",14,19,33,0,9
2012-09-25 22:45:41.000,"Jason Davies","Jason Davies",41,56,97,0,17
2012-09-25 22:14:32.000,"Jason Davies","Jason Davies",133,33,166,0,45
2012-09-25 19:31:35.000,"Mike Bostock","Mike Bostock",22,10,32,0,45
2012-09-25 18:41:20.000,"Mike Bostock","Mike Bostock",291,340,631,0,41
2012-09-25 17:59:25.000,"Mike Bostock","Mike Bostock",105,106,211,0,106
2012-09-25 11:49:13.000,"Jason Davies","Jason Davies",12,32,44,0,9
2012-09-24 18:11:40.000,"Jason Davies","Jason Davies",3,5,8,0,17
2012-09-24 13:41:35.000,"Jason Davies","Jason Davies",35,14,49,0,48
2012-09-24 10:23:59.000,"Jason Davies","Jason Davies",8,8,16,0,38
2012-09-24 10:22:48.000,"Jason Davies","Jason Davies",97,97,194,0,43
2012-09-24 03:34:32.000,"Mike Bostock","Mike Bostock",1,25,26,0,50
2012-09-24 03:33:04.000,"Mike Bostock","Mike Bostock",3,3,6,0,38
2012-09-24 01:29:25.000,"Mike Bostock","Mike Bostock",5,5,10,0,22
2012-09-24 01:28:20.000,"Mike Bostock","Mike Bostock",1,2,3,0,9
2012-09-24 01:27:46.000,"Mike Bostock","Mike Bostock",18,32,50,0,32
2012-09-24 01:05:12.000,"Mike Bostock","Mike Bostock",63,65,128,0,28
2012-09-24 00:49:11.000,"Mike Bostock","Mike Bostock",860,782,1642,0,101
2012-09-23 00:08:27.000,"Mike Bostock","Mike Bostock",25,13,38,0,50
2012-09-23 00:03:55.000,"Mike Bostock","Mike Bostock",13,20,33,0,102
2012-09-20 05:29:46.000,"Mike Bostock","Mike Bostock",12,0,12,0,31
2012-09-20 02:54:36.000,"Mike Bostock","Mike Bostock",6,117,123,3,49
2012-09-20 02:37:23.000,"Mike Bostock","Mike Bostock",117,6,123,0,242
2012-09-20 00:39:53.000,"Mike Bostock","Mike Bostock",14,18,32,0,17
2012-09-20 00:34:15.000,"Mike Bostock","Mike Bostock",6,9,15,0,40
2012-09-19 23:23:43.000,"Mike Bostock","Mike Bostock",37,48,85,0,105
2012-09-19 21:48:27.000,"Mike Bostock","Mike Bostock",5,6,11,0,29
2012-09-19 21:48:06.000,"Mike Bostock","Mike Bostock",1,3,4,0,16
2012-09-19 21:47:37.000,"Mike Bostock","Mike Bostock",1,1,2,0,21
2012-09-19 21:45:44.000,"Mike Bostock","Mike Bostock",11,4,15,0,82
2012-09-19 21:08:57.000,"Mike Bostock","Mike Bostock",5,7,12,0,95
2012-09-19 20:59:06.000,"Mike Bostock","Mike Bostock",72,72,144,0,47
2012-09-19 20:11:50.000,"Mike Bostock","Mike Bostock",12,6,18,0,31
2012-09-19 19:21:32.000,"Mike Bostock","Mike Bostock",24,24,48,0,113
2012-09-19 19:09:26.000,"Mike Bostock","Mike Bostock",101,92,193,0,49
2012-09-19 18:39:24.000,"Mike Bostock","Mike Bostock",5,5,10,0,12
2012-09-19 00:06:25.000,"Mike Bostock","Mike Bostock",6,6,12,0,101
2012-09-19 00:03:04.000,"Mike Bostock","Mike Bostock",5,5,10,0,41
2012-09-18 23:49:03.000,"Mike Bostock","Mike Bostock",194,89,283,0,419
2012-09-18 04:34:08.000,"Tim Branyen","Tim Branyen",6,0,6,0,37
2012-09-17 22:26:54.000,"Tim Branyen","Tim Branyen",6,0,6,0,15
2012-09-14 20:48:53.000,"Mike Bostock","Mike Bostock",6,6,12,0,37
2012-09-14 20:38:35.000,"Mike Bostock","Mike Bostock",18,0,18,0,36
2012-09-06 15:53:18.000,"Jason Davies","Jason Davies",26,24,50,0,39
2012-09-05 22:16:40.000,"Ger Hobbelt","Ger Hobbelt",2,2,4,0,109
2012-09-05 22:10:29.000,"Ger Hobbelt","Ger Hobbelt",5,3,8,0,217
2012-09-05 15:33:09.000,"Jason Davies","Jason Davies",4,4,8,0,103
2012-09-04 03:19:37.000,"Mike Bostock","Mike Bostock",6118,6103,12221,0,21
2012-09-04 03:18:32.000,"Mike Bostock","Mike Bostock",9,5,14,0,37
2012-09-04 03:08:11.000,"Mike Bostock","Mike Bostock",6015,6015,12030,0,68
2012-09-04 03:06:22.000,"Mike Bostock","Mike Bostock",9,4,13,0,51
2012-09-04 03:05:49.000,"Mike Bostock","Mike Bostock",5,5,10,0,70
2012-09-04 03:04:34.000,"Mike Bostock","Mike Bostock",3,6,9,0,73
2012-09-04 03:03:51.000,"Mike Bostock","Mike Bostock",5,5,10,0,73
2012-09-04 02:56:32.000,"Mike Bostock","Mike Bostock",15,9,24,0,36
2012-08-31 21:11:34.000,"Mike Bostock","Mike Bostock",71,68,139,0,20
2012-08-21 12:04:37.000,"Jason Davies","Jason Davies",5,5,10,0,107
2012-08-20 23:25:10.000,"Jason Davies","Jason Davies",0,1,1,0,53
2012-08-20 22:15:08.000,"Jason Davies","Jason Davies",3,5,8,0,235
2012-08-16 22:40:48.000,"Jason Davies","Jason Davies",7,7,14,0,19
2012-08-16 21:26:14.000,"Mike Bostock","Mike Bostock",11,6,17,0,39
2012-08-16 08:32:47.000,"Jason Davies","Jason Davies",19,5,24,0,35
2012-08-15 23:58:58.000,"Jason Davies","Jason Davies",48,7,55,0,32
2012-08-15 23:21:19.000,"Jason Davies","Jason Davies",95,39,134,0,199
2012-08-15 16:13:01.000,"Jason Davies","Jason Davies",8,8,16,0,113
2012-08-15 16:06:27.000,"Jason Davies","Jason Davies",69,143,212,0,67
2012-08-15 15:43:09.000,"Jason Davies","Jason Davies",139,4,143,0,112
2012-08-13 21:34:41.000,"Jason Davies","Jason Davies",16,23,39,0,9
2012-08-13 21:31:55.000,"Jason Davies","Jason Davies",37,32,69,0,117
2012-08-13 21:23:49.000,"Jason Davies","Jason Davies",22,20,42,0,48
2012-08-13 21:10:43.000,"Jason Davies","Jason Davies",6,7,13,0,21
2012-08-13 19:55:54.000,"Jason Davies","Jason Davies",93,64,157,0,228
2012-08-12 23:05:41.000,"Jason Davies","Jason Davies",6016,6016,12032,0,109
2012-08-12 22:17:50.000,"Jason Davies","Jason Davies",4,13,17,0,46
2012-08-12 18:45:27.000,"Jason Davies","Jason Davies",5,3,8,0,9
2012-08-12 18:45:12.000,"Jason Davies","Jason Davies",2,1,3,0,44
2012-08-12 18:34:05.000,"Jason Davies","Jason Davies",49,41,90,0,197
2012-08-12 16:56:02.000,"Mike Bostock","Mike Bostock",14,0,14,0,89
2012-08-12 10:22:50.000,"Jason Davies","Jason Davies",14,0,14,0,36
2012-08-10 04:11:48.000,"Mike Bostock","Mike Bostock",1975,976,2951,0,21
2012-08-10 02:46:28.000,"Mike Bostock","Mike Bostock",5,5,10,0,63
2012-08-09 05:22:21.000,"Mike Bostock","Mike Bostock",434,6,440,0,73
2012-08-09 04:40:36.000,"Mike Bostock","Mike Bostock",78,11,89,0,48
2012-08-09 04:33:23.000,"Mike Bostock","Mike Bostock",107,4,111,0,35
2012-08-09 03:12:43.000,"Mike Bostock","Mike Bostock",69,44,113,1,38
2012-08-09 02:08:47.000,"Mike Bostock","Mike Bostock",527,216,743,0,124
2012-08-09 01:53:46.000,"Mike Bostock","Mike Bostock",60,66,126,0,136
2012-08-09 01:36:40.000,"Mike Bostock","Mike Bostock",76,59,135,0,62
2012-08-09 01:36:01.000,"Mike Bostock","Mike Bostock",392,241,633,0,76
2012-08-09 01:35:19.000,"Mike Bostock","Mike Bostock",48,31,79,0,70
2012-08-09 01:34:25.000,"Mike Bostock","Mike Bostock",50,37,87,0,104
2012-08-09 01:32:32.000,"Mike Bostock","Mike Bostock",41,201,242,0,109
2012-08-09 01:30:36.000,"Mike Bostock","Mike Bostock",67,96,163,0,45
2012-08-07 20:35:10.000,"Mike Bostock","Mike Bostock",46,55,101,2,38
2012-08-07 20:19:18.000,"Mike Bostock","Mike Bostock",75,95,170,0,214
2012-08-06 00:39:11.000,"Mike Bostock","Mike Bostock",44,5,49,0,40
2012-08-06 00:29:04.000,"Mike Bostock","Mike Bostock",87,47,134,0,31
2012-08-05 23:52:10.000,"Mike Bostock","Mike Bostock",27,141,168,0,46
2012-08-05 22:54:02.000,"Mike Bostock","Mike Bostock",241,135,376,0,36
2012-08-05 18:42:28.000,"Mike Bostock","Mike Bostock",24,22,46,0,39
2012-08-05 18:38:00.000,"Mike Bostock","Mike Bostock",42,35,77,0,39
2012-08-05 18:09:16.000,"Mike Bostock","Mike Bostock",31,28,59,0,42
2011-08-29 01:07:55.000,"Mike Bostock","Mike Bostock",81,12,93,0,37
2011-08-29 00:59:40.000,"Mike Bostock","Mike Bostock",106,16,122,0,34
2011-08-29 00:25:48.000,"Mike Bostock","Mike Bostock",81,19,100,0,33
2012-08-04 20:11:35.000,"Mike Bostock","Mike Bostock",23,181,204,0,379
2012-08-04 20:02:17.000,"Mike Bostock","Mike Bostock",22,18,40,0,63
2012-08-03 01:50:14.000,"Mike Bostock","Mike Bostock",38,38,76,0,35
2012-08-03 01:48:26.000,"Mike Bostock","Mike Bostock",38,38,76,1,196
2012-08-01 22:31:00.000,"Mike Bostock","Mike Bostock",40,24,64,0,45
2012-08-01 22:29:21.000,"Mike Bostock","Mike Bostock",40,0,40,0,39
2012-08-01 13:31:48.000,"Jason Davies","Jason Davies",1,1,2,0,46
2012-08-01 13:07:13.000,"Jason Davies","Jason Davies",28,22,50,0,343
2012-08-01 03:38:36.000,"Mike Bostock","Mike Bostock",40,24,64,0,113
2012-07-31 22:59:49.000,"Mike Bostock","Mike Bostock",10319,12496,22815,0,20
2012-07-31 22:54:04.000,"Mike Bostock","Mike Bostock",1,1,2,0,179
2012-07-31 22:46:28.000,"Mike Bostock","Mike Bostock",177,70,247,0,149
2012-07-31 21:56:18.000,"Mike Bostock","Mike Bostock",12,27,39,0,280
2012-07-31 21:30:39.000,"Mike Bostock","Mike Bostock",71,5,76,0,73
2012-07-31 21:29:20.000,"Mike Bostock","Mike Bostock",3,5,8,0,27
2012-07-31 21:20:26.000,"Mike Bostock","Mike Bostock",18,31,49,0,75
2012-07-31 16:15:30.000,"Jason Davies","Jason Davies",11,14,25,0,93
2012-07-31 14:51:49.000,"Jason Davies","Jason Davies",53,10,63,0,47
2012-07-31 14:00:26.000,"Jason Davies","Jason Davies",71,5,76,0,37
2012-07-31 13:38:41.000,"Jason Davies","Jason Davies",94,88,182,0,79
2012-07-31 13:01:45.000,"Jason Davies","Jason Davies",74,37,111,0,271
2012-07-31 11:43:35.000,"Jason Davies","Jason Davies",5,5,10,0,43
2012-07-31 08:38:13.000,"Mike Bostock","Mike Bostock",22,11,33,0,40
2012-07-31 08:30:31.000,"Mike Bostock","Mike Bostock",14,5,19,0,53
2012-07-31 08:27:14.000,"Mike Bostock","Mike Bostock",79,79,158,0,41
2012-07-31 07:43:35.000,"Mike Bostock","Mike Bostock",7,7,14,0,38
2012-07-31 07:39:40.000,"Mike Bostock","Mike Bostock",3185,3215,6400,0,41
2012-07-31 03:43:47.000,"Mike Bostock","Mike Bostock",6651,9256,15907,0,34
2012-07-31 03:42:32.000,"Mike Bostock","Mike Bostock",222,205,427,0,80
2012-07-31 02:54:22.000,"Mike Bostock","Mike Bostock",207,103,310,0,70
2012-07-31 02:20:11.000,"Mike Bostock","Mike Bostock",13,9,22,0,75
2012-07-31 02:18:48.000,"Mike Bostock","Mike Bostock",48,24,72,0,44
2012-07-31 02:18:04.000,"Mike Bostock","Mike Bostock",20,14,34,0,67
2012-07-31 02:17:15.000,"Mike Bostock","Mike Bostock",6,16,22,0,53
2012-07-31 02:16:33.000,"Mike Bostock","Mike Bostock",11,7,18,0,79
2012-07-31 02:13:32.000,"Mike Bostock","Mike Bostock",25,3,28,0,79
2012-07-31 02:12:37.000,"Mike Bostock","Mike Bostock",128,4,132,0,78
2012-07-31 02:11:07.000,"Mike Bostock","Mike Bostock",16,16,32,0,69
2012-07-31 01:05:24.000,"Mike Bostock","Mike Bostock",3185,3215,6400,0,81
2012-07-26 01:26:06.000,"Steven Noble","Steven Noble",4,4,8,0,25
2012-07-26 01:25:03.000,"Steven Noble","Steven Noble",5,3,8,0,77
2012-07-26 00:24:26.000,"Steven Noble","Steven Noble",1,1,2,0,166
2012-07-26 00:23:22.000,"Steven Noble","Steven Noble",1,1,2,0,59
2012-07-25 21:35:03.000,"Jason Davies","Jason Davies",18,31,49,0,328
2012-07-25 19:34:38.000,"Jason Davies","Jason Davies",128,21,149,0,60
2012-07-25 18:22:03.000,"Jason Davies","Jason Davies",5,5,10,0,69
2012-07-25 18:18:44.000,"Jason Davies","Jason Davies",4,0,4,0,17
2012-07-25 15:26:05.000,"Jason Davies","Jason Davies",8,8,16,0,39
2012-07-25 13:46:20.000,"Jason Davies","Jason Davies",16,16,32,0,103
2012-07-25 13:00:40.000,"Jason Davies","Jason Davies",12,12,24,0,82
2012-07-25 10:58:06.000,"Jason Davies","Jason Davies",2,2,4,0,22
2012-07-25 10:02:49.000,"Jason Davies","Jason Davies",21,8,29,0,73
2012-07-24 21:25:55.000,"Jason Davies","Jason Davies",70,74,144,0,47
2012-07-24 21:17:11.000,"Jason Davies","Jason Davies",238,204,442,0,85
2012-07-24 19:48:26.000,"Jason Davies","Jason Davies",84,84,168,0,45
2012-07-24 18:38:05.000,"Jason Davies","Jason Davies",131,57,188,0,552
2012-07-23 18:34:39.000,"Jason Davies","Jason Davies",25,3,28,0,49
2012-07-23 16:08:26.000,"Jason Davies","Jason Davies",16,11,27,0,436
2012-07-21 02:00:10.000,"Nathan Vander Wilt","Nathan Vander Wilt",11,9,20,0,82
2012-07-19 19:07:36.000,"Mike Bostock","Mike Bostock",6579,9178,15757,0,163
2012-07-19 19:02:35.000,"Mike Bostock","Mike Bostock",2,1,3,0,19
2012-07-17 22:00:08.000,"Mike Bostock","Mike Bostock",18,18,36,0,81
2012-07-17 21:45:34.000,"Mike Bostock","Mike Bostock",31,7,38,0,95
2012-07-17 21:45:18.000,"Mike Bostock","Mike Bostock",2,1,3,0,19
2012-07-13 17:02:12.000,"Mike Bostock","Mike Bostock",5,2,7,0,24
2012-07-10 16:37:52.000,"Jason Davies","Jason Davies",18,18,36,0,172
2012-07-05 08:42:36.000,"Jason Davies","Jason Davies",20,14,34,0,368
2012-07-04 19:22:08.000,"Mike Bostock","Mike Bostock",15,5,20,0,44
2012-07-04 19:21:05.000,"Mike Bostock","Mike Bostock",6,16,22,0,28
2012-07-03 02:08:52.000,"Mike Bostock","Mike Bostock",328,243,571,0,20
2012-07-03 02:06:53.000,"Mike Bostock","Mike Bostock",54,36,90,0,45
2012-07-03 02:06:23.000,"Mike Bostock","Mike Bostock",64,86,150,0,41
2012-07-03 02:05:51.000,"Mike Bostock","Mike Bostock",22,20,42,0,45
2012-07-03 01:42:23.000,"Mike Bostock","Mike Bostock",11,6,17,0,175
2012-07-03 00:58:54.000,"Mike Bostock","Mike Bostock",140,82,222,0,178
2012-07-02 18:59:06.000,"Mike Bostock","Mike Bostock",16,36,52,0,23
2012-07-02 17:02:52.000,"Jason Davies","Jason Davies",34,0,34,0,38
2012-07-02 16:53:51.000,"Jason Davies","Jason Davies",16,6,22,0,45
2012-07-02 09:19:39.000,"Jason Davies","Jason Davies",8,8,16,0,190
2012-06-30 18:35:58.000,"Mike Bostock","Mike Bostock",59,54,113,0,173
2012-06-29 04:41:33.000,"Mike Bostock","Mike Bostock",48,28,76,0,142
2012-06-29 01:43:26.000,"Mike Bostock","Mike Bostock",22,20,42,0,60
2012-06-28 20:57:36.000,"Mike Bostock","Mike Bostock",406,253,659,1,186
2012-06-28 20:21:32.000,"Mike Bostock","Mike Bostock",64,86,150,0,165
2012-06-28 04:03:08.000,"Mike Bostock","Mike Bostock",80,64,144,0,531
2012-06-25 21:03:55.000,"Mike Bostock","Mike Bostock",54,36,90,0,276
2012-06-24 19:03:14.000,"Mike Bostock","Mike Bostock",194,75,269,0,20
2012-06-24 18:59:40.000,"Mike Bostock","Mike Bostock",132,3,135,0,48
2012-06-24 18:59:06.000,"Mike Bostock","Mike Bostock",8,12,20,0,48
2012-06-24 18:43:13.000,"Mike Bostock","Mike Bostock",134,7,141,0,43
2012-06-24 18:00:28.000,"Mike Bostock","Mike Bostock",3,3,6,0,25
2012-06-24 17:59:41.000,"Mike Bostock","Mike Bostock",5,7,12,0,20
2012-06-24 17:22:23.000,"Mike Bostock","Mike Bostock",58,64,122,0,845
2012-06-22 01:37:34.000,"Mike Bostock","Mike Bostock",84,53,137,0,49
2012-06-22 01:35:23.000,"Mike Bostock","Mike Bostock",7,5,12,0,45
2012-06-20 23:14:10.000,"Dirk Bergstrom","Dirk Bergstrom",1,3,4,0,156
2012-06-19 17:15:34.000,"Mike Bostock","Mike Bostock",23,19,42,0,20
2012-06-19 17:12:56.000,"Mike Bostock","Mike Bostock",5,5,10,0,64
2012-06-19 17:11:53.000,"Mike Bostock","Mike Bostock",5,5,10,0,66
2012-06-19 16:50:37.000,"Mike Bostock","Mike Bostock",13,9,22,0,78
2012-06-14 17:34:45.000,"Mike Bostock","Mike Bostock",67,40,107,0,20
2012-06-14 17:33:49.000,"Mike Bostock","Mike Bostock",25,9,34,0,39
2012-05-29 23:16:22.000,"Mike Bostock","Mike Bostock",25,9,34,0,239
2012-06-14 17:29:39.000,"Mike Bostock","Mike Bostock",6,3,9,0,62
2012-06-14 17:26:57.000,"Mike Bostock","Mike Bostock",38,30,68,0,74
2012-06-01 04:26:45.000,"Brandon Liu","Brandon Liu",9,6,15,0,79
2012-05-29 14:43:52.000,"George Adams","George Adams",1,1,2,0,376
2012-05-27 16:13:10.000,"Jason Davies","Jason Davies",3,3,6,0,23
2012-05-27 15:25:08.000,"Jason Davies","Jason Davies",10,6,16,0,292
2012-05-16 17:57:18.000,"Mike Bostock","Mike Bostock",22,17,39,0,20
2012-05-16 17:56:18.000,"Mike Bostock","Mike Bostock",11,10,21,0,48
2012-05-11 14:49:48.000,"Jason Davies","Jason Davies",6,4,10,0,37
2012-05-11 09:51:12.000,"Jason Davies","Jason Davies",5,3,8,0,43
2012-05-10 23:23:31.000,"Jason Davies","Jason Davies",2,2,4,0,42
2012-05-09 22:04:00.000,"Jason Davies","Jason Davies",38,30,68,0,222
2012-05-09 18:29:22.000,"Mike Bostock","Mike Bostock",2,1,3,0,41
2012-05-04 07:41:25.000,"Jason Davies","Jason Davies",6,40,46,0,520
2012-05-03 15:59:42.000,"Jason Davies","Jason Davies",38,4,42,0,311
2012-05-01 16:50:25.000,"Mike Bostock","Mike Bostock",2,2,4,0,20
2012-05-01 15:35:58.000,"Lachèze Alexandre","Lachèze Alexandre",3,0,3,0,28
2012-04-26 17:31:22.000,"webmonarch","webmonarch",1,1,2,0,30
2012-04-26 17:27:35.000,"webmonarch","webmonarch",0,4,4,0,29
2012-04-26 07:01:47.000,"webmonarch","webmonarch",1,1,2,0,89
2012-04-26 06:18:02.000,"Mike Bostock","Mike Bostock",11,10,21,0,110
2012-04-26 05:51:18.000,"webmonarch","webmonarch",1,3,4,0,86
2012-04-26 02:59:42.000,"webmonarch","webmonarch",2,0,2,0,81
2012-04-26 02:39:03.000,"webmonarch","webmonarch",1,1,2,0,43
2012-04-26 00:31:48.000,"webmonarch","webmonarch",1,1,2,0,92
2012-04-25 02:27:23.000,"Mike Bostock","Mike Bostock",3,53,56,0,39
2012-04-19 02:30:22.000,"Mike Bostock","Mike Bostock",6,10,16,0,85
2012-04-15 22:42:51.000,"Mike Bostock","Mike Bostock",1794,1176,2970,0,20
2012-04-15 22:39:54.000,"Mike Bostock","Mike Bostock",3,5,8,0,180
2012-04-15 22:30:52.000,"Mike Bostock","Mike Bostock",17,13,30,0,27
2012-04-15 22:13:43.000,"Mike Bostock","Mike Bostock",880,713,1593,0,89
2012-04-15 22:12:37.000,"Mike Bostock","Mike Bostock",2,7,9,0,68
2012-04-15 19:59:56.000,"Jason Davies","Jason Davies",2,7,9,0,63
2012-04-15 19:45:57.000,"Jason Davies","Jason Davies",3,3,6,0,158
2012-04-07 05:36:20.000,"Kristofer Monisit","Kristofer Monisit",11,4,15,0,29
2012-04-07 05:34:26.000,"Kristofer Monisit","Kristofer Monisit",5,5,10,0,32
2012-04-07 05:33:34.000,"Kristofer Monisit","Kristofer Monisit",16,13,29,0,35
2012-04-07 05:30:46.000,"Kristofer Monisit","Kristofer Monisit",10,10,20,0,33
2012-04-07 05:26:22.000,"Kristofer Monisit","Kristofer Monisit",23,23,46,0,30
2012-04-07 03:03:58.000,"Kristofer Monisit","Kristofer Monisit",6,6,12,0,34
2012-04-07 02:59:56.000,"Kristofer Monisit","Kristofer Monisit",24,16,40,0,38
2012-04-07 02:48:52.000,"Kristofer Monisit","Kristofer Monisit",22,22,44,0,32
2012-04-07 02:39:35.000,"Kristofer Monisit","Kristofer Monisit",7,2,9,0,30
2012-04-07 02:35:35.000,"Kristofer Monisit","Kristofer Monisit",9,9,18,0,31
2012-04-07 02:33:30.000,"Kristofer Monisit","Kristofer Monisit",17,10,27,0,29
2012-04-07 02:26:49.000,"Kristofer Monisit","Kristofer Monisit",55,51,106,0,33
2012-04-07 02:21:04.000,"Kristofer Monisit","Kristofer Monisit",14,8,22,0,31
2012-04-07 02:17:27.000,"Kristofer Monisit","Kristofer Monisit",8,8,16,0,33
2012-04-07 02:15:43.000,"Kristofer Monisit","Kristofer Monisit",9,9,18,0,27
2012-04-06 17:42:24.000,"Kristofer Monisit","Kristofer Monisit",12,8,20,0,35
2012-04-06 17:39:49.000,"Kristofer Monisit","Kristofer Monisit",16,15,31,0,29
2012-04-06 17:37:01.000,"Kristofer Monisit","Kristofer Monisit",40,30,70,0,34
2012-04-06 17:30:29.000,"Kristofer Monisit","Kristofer Monisit",11,9,20,0,33
2012-04-06 17:26:45.000,"Kristofer Monisit","Kristofer Monisit",5,5,10,0,29
2012-04-06 17:25:31.000,"Kristofer Monisit","Kristofer Monisit",6,6,12,0,30
2012-04-06 17:22:20.000,"Kristofer Monisit","Kristofer Monisit",5,5,10,0,31
2012-04-06 17:20:49.000,"Kristofer Monisit","Kristofer Monisit",16,10,26,0,34
2012-04-06 17:17:09.000,"Kristofer Monisit","Kristofer Monisit",16,10,26,0,28
2012-04-06 17:10:40.000,"Kristofer Monisit","Kristofer Monisit",6,6,12,0,29
2012-04-06 17:09:32.000,"Kristofer Monisit","Kristofer Monisit",23,23,46,0,32
2012-04-06 17:07:16.000,"Kristofer Monisit","Kristofer Monisit",18,6,24,0,30
2012-04-06 12:19:37.000,"Kristofer Monisit","Kristofer Monisit",4,4,8,0,34
2012-04-06 11:54:10.000,"Kristofer Monisit","Kristofer Monisit",57,53,110,0,31
2012-04-06 11:49:52.000,"Kristofer Monisit","Kristofer Monisit",9,9,18,0,29
2012-04-06 11:48:58.000,"Kristofer Monisit","Kristofer Monisit",19,14,33,0,28
2012-04-06 11:47:11.000,"Kristofer Monisit","Kristofer Monisit",13,13,26,0,30
2012-04-06 05:42:30.000,"Kristofer Monisit","Kristofer Monisit",254,215,469,0,25
2012-04-06 05:34:54.000,"Kristofer Monisit","Kristofer Monisit",5,5,10,0,33
2012-04-06 05:30:22.000,"Kristofer Monisit","Kristofer Monisit",4,4,8,0,31
2012-04-06 05:23:25.000,"Kristofer Monisit","Kristofer Monisit",21,21,42,0,32
2012-04-06 05:19:31.000,"Kristofer Monisit","Kristofer Monisit",10,10,20,0,32
2012-04-06 05:16:33.000,"Kristofer Monisit","Kristofer Monisit",10,10,20,0,30
2012-04-06 05:00:55.000,"Kristofer Monisit","Kristofer Monisit",19,19,38,0,31
2012-04-06 04:46:26.000,"Kristofer Monisit","Kristofer Monisit",53,51,104,0,33
2012-04-06 03:38:33.000,"Kristofer Monisit","Kristofer Monisit",7,7,14,0,31
2012-04-06 03:33:12.000,"Kristofer Monisit","Kristofer Monisit",9,9,18,0,31
2012-04-06 03:17:20.000,"Kristofer Monisit","Kristofer Monisit",55,48,103,0,31
2012-04-06 03:14:06.000,"Kristofer Monisit","Kristofer Monisit",8,8,16,0,28
2012-04-06 02:49:16.000,"Kristofer Monisit","Kristofer Monisit",30,20,50,0,43
2012-04-05 16:21:17.000,"Kristofer Monisit","Kristofer Monisit",90,71,161,0,44
2012-04-04 18:44:22.000,"Mike Bostock","Mike Bostock",549,464,1013,0,53
2012-04-04 16:12:12.000,"Kristofer Monisit","Kristofer Monisit",165,0,165,0,41
2012-04-04 15:30:48.000,"Kristofer Monisit","Kristofer Monisit",97,0,97,0,434
2012-04-03 16:48:50.000,"Mike Bostock","Mike Bostock",10,10,20,0,70
2012-04-03 14:00:44.000,"Jason Davies","Jason Davies",5,5,10,0,39
2012-04-03 13:59:38.000,"Jason Davies","Jason Davies",8,8,16,0,28
2012-03-30 06:11:25.000,"Mike Bostock","Mike Bostock",3,2,5,0,20
2012-03-30 06:09:37.000,"Mike Bostock","Mike Bostock",2,1,3,0,65
2012-03-30 06:07:11.000,"Mike Bostock","Mike Bostock",19,15,34,0,36
2012-03-30 06:01:48.000,"Mike Bostock","Mike Bostock",8,2,10,0,68
2012-03-30 06:00:15.000,"Mike Bostock","Mike Bostock",3,2,5,0,36
2012-03-30 05:57:47.000,"Mike Bostock","Mike Bostock",5,2,7,0,71
2012-03-30 05:57:28.000,"Mike Bostock","Mike Bostock",5,3,8,0,78
2012-03-30 05:56:51.000,"Mike Bostock","Mike Bostock",6,2,8,0,78
2012-03-30 05:55:56.000,"Mike Bostock","Mike Bostock",292,220,512,0,44
2012-03-30 05:55:27.000,"Mike Bostock","Mike Bostock",12,5,17,0,54
2012-03-30 05:55:04.000,"Mike Bostock","Mike Bostock",5,5,10,0,53
2012-03-30 02:00:27.000,"Michael Meisel","Michael Meisel",1,1,2,0,66
2012-03-28 17:43:18.000,"Mike Bostock","Mike Bostock",5,5,10,0,47
2012-03-23 17:18:45.000,"David Poncelow","David Poncelow",250,0,250,0,46
2012-03-23 13:22:07.000,"Jon Seymour","Jon Seymour",4,0,4,0,121
2012-03-23 12:30:08.000,"Jon Seymour","Jon Seymour",4,2,6,0,625
2012-03-23 12:06:03.000,"Jason Davies","Jason Davies",11,5,16,0,104
2012-03-20 18:48:13.000,"Michael Meisel","Michael Meisel",1,0,1,0,56
2012-03-19 22:49:09.000,"Mike Bostock","Mike Bostock",14,8,22,0,81
2012-03-19 21:45:28.000,"Mike Bostock","Mike Bostock",189,186,375,0,407
2012-03-18 18:03:29.000,"Mike Bostock","Mike Bostock",8,2,10,0,20
2012-03-18 18:02:43.000,"Mike Bostock","Mike Bostock",4,0,4,0,47
2012-03-17 23:18:59.000,"Mike Bostock","Mike Bostock",240,0,240,0,22
2012-03-17 00:40:58.000,"Mike Bostock","Mike Bostock",76,52,128,0,17
2012-03-17 00:32:33.000,"Mike Bostock","Mike Bostock",38,6,44,0,17
2012-03-17 00:16:58.000,"Mike Bostock","Mike Bostock",41,34,75,0,34
2012-03-16 17:46:21.000,"Jason Davies","Jason Davies",6,8,14,0,57
2012-03-16 16:52:44.000,"Jason Davies","Jason Davies",6,6,12,0,56
2012-03-16 16:50:07.000,"Jason Davies","Jason Davies, working on the server",10,6,16,0,100
2012-03-16 16:42:02.000,"Jason Davies","Jason Davies",4,4,8,0,151
2012-03-16 16:21:03.000,"Jason Davies","Jason Davies",6,4,10,0,138
2012-03-16 14:49:10.000,"Jason Davies","Jason Davies",3,3,6,0,177
2012-03-16 01:14:48.000,"Kristofer Monisit","Kristofer Monisit",5,9,14,0,41
2012-03-15 15:28:21.000,"Mike Bostock","Mike Bostock",4,0,4,0,80
2012-03-15 08:56:43.000,"Kristofer Monisit","Kristofer Monisit",11,5,16,0,50
2012-03-09 00:08:41.000,"David Poncelow","David Poncelow",1,1,2,0,54
2012-03-08 23:44:09.000,"David Poncelow","David Poncelow",5,2,7,0,52
2012-03-08 09:41:13.000,"Mike Bostock","Mike Bostock",12,5,17,0,104
2012-03-07 01:41:13.000,"Mike Bostock","Mike Bostock",1,1,2,0,61
2012-03-06 23:36:00.000,"Carlos Scheidegger","Carlos Scheidegger",1,1,2,0,16
2012-03-04 19:41:39.000,"Jason Davies","Jason Davies",6,6,12,0,83
2012-03-04 11:52:51.000,"Jason Davies","Jason Davies",1,1,2,0,9
2012-03-04 11:37:24.000,"Jason Davies","Jason Davies",4,2,6,0,41
2012-03-04 11:31:47.000,"Jason Davies","Jason Davies",10,6,16,0,180
2012-03-02 00:30:25.000,"Mike Bostock","Mike Bostock",377,322,699,0,22
2012-03-02 00:29:35.000,"Mike Bostock","Mike Bostock",82,64,146,0,43
2012-03-02 00:29:17.000,"Mike Bostock","Mike Bostock",180,235,415,0,53
2012-03-02 00:25:30.000,"Mike Bostock","Mike Bostock",4,4,8,0,100
2012-02-29 19:27:30.000,"Mike Bostock","Mike Bostock",180,235,415,0,124
2012-02-29 02:27:40.000,"Mike Bostock","Mike Bostock",116,24,140,0,320
2012-02-29 01:52:16.000,"Mike Bostock","Mike Bostock",113,67,180,0,25
2012-02-27 00:16:49.000,"Mike Bostock","Mike Bostock",20,14,34,0,178
2012-02-26 23:46:26.000,"Mike Bostock","Mike Bostock",76,64,140,0,469
2012-02-25 07:36:51.000,"Mike Bostock","Mike Bostock",2,2,4,0,62
2012-02-25 05:14:55.000,"Stephen Bannasch","Stephen Bannasch",1,1,2,0,378
2012-02-25 03:19:34.000,"Mike Bostock","Mike Bostock",4413,2381,6794,0,21
2012-02-23 18:32:42.000,"Mike Bostock","Mike Bostock",174,8,182,0,174
2012-02-23 06:50:40.000,"Mike Bostock","Mike Bostock",12,12,24,0,27
2012-02-23 06:40:44.000,"Mike Bostock","Mike Bostock",414,454,868,0,92
2012-02-23 05:59:13.000,"Mike Bostock","Mike Bostock",122,170,292,0,51
2012-02-23 05:39:02.000,"Mike Bostock","Mike Bostock",41,17,58,0,349
2012-02-23 01:58:25.000,"Mike Bostock","Mike Bostock",61,36,97,0,64
2012-02-23 01:22:00.000,"Mike Bostock","Mike Bostock",170,150,320,0,328
2012-02-22 22:13:25.000,"Mike Bostock","Mike Bostock",36,24,60,0,38
2012-02-22 22:06:30.000,"Mike Bostock","Mike Bostock",59,18,77,0,37
2012-02-22 07:17:59.000,"Mike Bostock","Mike Bostock",8,8,16,0,37
2012-02-22 06:14:36.000,"Mike Bostock","Mike Bostock",105,5,110,0,76
2012-02-22 06:05:21.000,"Mike Bostock","Mike Bostock",37,6,43,0,68
2012-02-22 05:55:18.000,"Mike Bostock","Mike Bostock",153,77,230,0,75
2012-02-22 02:31:55.000,"Mike Bostock","Mike Bostock",54,14,68,0,237
2012-02-22 00:07:01.000,"Michael Jackson","Michael Jackson",4,0,4,0,32
2012-02-21 18:41:43.000,"Mike Bostock","Mike Bostock",110,59,169,1,254
2012-02-21 18:31:15.000,"Mike Bostock","Mike Bostock",105,67,172,0,32
2012-02-21 18:03:23.000,"Mike Bostock","Mike Bostock",24,32,56,0,189
2012-02-21 17:04:00.000,"Mike Bostock","Mike Bostock",9,9,18,0,27
2012-02-21 16:57:55.000,"Mike Bostock","Mike Bostock",31,22,53,0,32
2012-02-21 16:55:03.000,"Mike Bostock","Mike Bostock",30,16,46,0,45
2012-02-21 16:47:57.000,"Mike Bostock","Mike Bostock",48,40,88,0,33
2012-02-21 16:42:37.000,"Mike Bostock","Mike Bostock",15,6,21,0,44
2012-02-21 16:39:42.000,"Mike Bostock","Mike Bostock",40,24,64,0,105
2012-02-21 16:23:23.000,"Mike Bostock","Mike Bostock",18,18,36,0,265
2012-02-21 16:18:27.000,"Mike Bostock","Mike Bostock",4,6,10,0,86
2012-02-21 13:15:38.000,"Jason Davies","Jason Davies",4,6,10,0,122
2012-02-21 06:57:25.000,"Mike Bostock","Mike Bostock",18,18,36,0,40
2012-02-21 06:54:38.000,"Mike Bostock","Mike Bostock",15,17,32,0,29
2012-02-21 06:49:31.000,"Mike Bostock","Mike Bostock",22,15,37,0,182
2012-02-21 06:32:46.000,"Mike Bostock","Mike Bostock",14,8,22,0,32
2012-02-21 06:28:42.000,"Mike Bostock","Mike Bostock",7,7,14,0,97
2012-02-21 05:26:27.000,"Mike Bostock","Mike Bostock",127,61,188,0,270
2012-02-21 04:40:43.000,"Mike Bostock","Mike Bostock",61,50,111,0,166
2012-02-21 04:24:11.000,"Mike Bostock","Mike Bostock",18,18,36,0,28
2012-02-21 04:14:24.000,"Mike Bostock","Mike Bostock",12,48,60,0,23
2012-02-20 20:28:10.000,"Zee Agency","Zee Agency",3,0,3,0,59
2012-02-20 20:25:23.000,"Jason Davies","Jason Davies",7,5,12,0,9
2012-02-20 19:57:19.000,"Jason Davies","Jason Davies",373,53,426,0,49
2012-02-20 19:23:36.000,"Mike Bostock","Mike Bostock",265,4,269,0,235
2012-02-20 08:52:45.000,"Jason Davies","Jason Davies",24,11,35,0,49
2012-02-20 05:00:01.000,"Jason Davies","Jason Davies",3,7,10,0,26
2012-02-20 04:52:53.000,"Jason Davies","Jason Davies",1,2,3,0,9
2012-02-20 04:52:44.000,"Mike Bostock","Mike Bostock",66,5,71,0,34
2012-02-20 04:46:52.000,"Jason Davies","Jason Davies",2374,1353,3727,0,96
2012-02-20 04:45:58.000,"Jason Davies","Jason Davies",5,7,12,0,9
2012-02-20 04:43:44.000,"Jason Davies","Jason Davies",13,13,26,0,39
2012-02-20 04:15:14.000,"Jason Davies","Jason Davies",6,6,12,0,95
2012-02-20 04:11:48.000,"Jason Davies","Jason Davies",6,6,12,0,150
2012-02-20 04:06:20.000,"Jason Davies","Jason Davies",45,13,58,0,46
2012-02-20 03:31:02.000,"Jason Davies","Jason Davies",15,9,24,0,53
2012-02-20 03:18:43.000,"Mike Bostock","Mike Bostock",47,13,60,0,29
2012-02-20 03:18:10.000,"Jason Davies","Jason Davies",22,11,33,0,219
2012-02-20 01:14:41.000,"Mike Bostock","Mike Bostock",248,115,363,0,80
2012-02-20 01:00:04.000,"Mike Bostock","Mike Bostock",70,72,142,0,777
2012-02-19 23:56:06.000,"Jason Davies","Jason Davies",6,6,12,0,71
2012-02-19 23:54:42.000,"Jason Davies","Jason Davies",93,0,93,0,235
2012-02-19 23:20:56.000,"Jason Davies","Jason Davies",8,8,16,0,9
2012-02-19 23:20:30.000,"Jason Davies","Jason Davies",1,1,2,0,17
2012-02-19 21:35:09.000,"Mike Bostock","Mike Bostock",1,1,2,0,22
2012-02-19 21:34:19.000,"Mike Bostock","Mike Bostock",0,6,6,0,21
2012-02-19 21:28:16.000,"Mike Bostock","Mike Bostock",505,539,1044,0,38
2012-02-19 21:24:17.000,"Mike Bostock","Mike Bostock",299,119,418,0,52
2012-02-19 20:24:38.000,"Mike Bostock","Mike Bostock",399,5,404,0,163
2012-02-19 20:13:34.000,"Jason Davies","Jason Davies",8033,13854,21887,0,100
2012-02-19 20:10:47.000,"Jason Davies","Jason Davies",95,95,190,0,29
2012-02-19 19:54:32.000,"Jason Davies","Jason Davies",6,4,10,0,307
2012-02-19 06:56:54.000,"Mike Bostock","Mike Bostock",383,337,720,0,718
2012-02-19 06:00:47.000,"Mike Bostock","Mike Bostock",99,167,266,0,112
2012-02-19 05:23:17.000,"Mike Bostock","Mike Bostock",556,206,762,0,30
2012-02-19 04:36:06.000,"Mike Bostock","Mike Bostock",144,150,294,0,197
2012-02-18 21:14:52.000,"Mike Bostock","Mike Bostock",5612,6901,12513,1,648
2012-02-18 21:10:03.000,"Mike Bostock","Mike Bostock",109,65,174,0,21
2012-02-18 21:05:02.000,"Mike Bostock","Mike Bostock",34,18,52,0,368
2012-02-18 19:48:11.000,"Mike Bostock","Mike Bostock",3,1,4,0,47
2012-02-18 19:46:18.000,"Mike Bostock","Mike Bostock",27,1,28,0,46
2012-02-18 19:40:32.000,"Mike Bostock","Mike Bostock",23,31,54,0,70
2012-02-18 19:39:43.000,"Mike Bostock","Mike Bostock",14,6,20,0,41
2012-02-18 19:39:24.000,"Mike Bostock","Mike Bostock",7,7,14,0,74
2012-02-17 16:40:27.000,"Mike Bostock","Mike Bostock",34,26,60,0,32
2012-02-17 15:56:55.000,"Jason Davies","Jason Davies",266,8,274,0,105
2012-02-17 14:23:38.000,"Jason Davies","Jason Davies",30,10,40,0,52
2012-02-16 16:43:19.000,"Mike Bostock","Mike Bostock",236,0,236,0,88
2012-02-16 16:19:53.000,"Jason Davies","Jason Davies",2,2,4,0,41
2012-02-16 16:16:51.000,"Jason Davies","Jason Davies",18,0,18,0,51
2012-02-16 12:49:20.000,"Jason Davies","Jason Davies",7,7,14,0,324
2012-02-16 09:50:16.000,"Jason Davies","Jason Davies",3,5,8,0,15
2012-02-16 09:45:50.000,"Jason Davies","Jason Davies",13,20,33,0,9
2012-02-16 09:02:06.000,"Jason Davies","Jason Davies",227,0,227,0,375
2012-02-15 22:23:27.000,"Trevor Norris","Trevor Norris",33,17,50,0,126
2012-02-15 06:26:12.000,"Mike Bostock","Mike Bostock",5,5,10,0,252
2012-02-15 06:07:57.000,"Mike Bostock","Mike Bostock",30,23,53,0,272
2012-02-15 05:59:47.000,"Ian Malpass","Ian Malpass",13,1,14,0,51
2012-02-15 05:18:42.000,"Ian Malpass","Ian Malpass",17,5,22,0,146
2012-02-15 00:32:47.000,"Mike Bostock","Mike Bostock",250,107,357,0,706
2012-02-15 00:43:15.000,"Mike Bostock","Mike Bostock",5,6,11,0,43
2012-02-15 00:09:52.000,"Trevor Norris","Trevor Norris",1,1,2,0,30
2012-02-15 00:04:03.000,"Trevor Norris","Trevor Norris",6,3,9,0,26
2012-02-15 00:03:38.000,"Trevor Norris","Trevor Norris",6,2,8,0,88
2012-02-14 20:14:45.000,"Jason Davies","Jason Davies",73,0,73,0,39
2012-02-14 18:49:16.000,"Jason Davies","Jason Davies",2,0,2,0,18
2012-02-14 18:46:48.000,"Jason Davies","Jason Davies",6,30,36,0,61
2012-02-14 18:45:13.000,"Jason Davies","Jason Davies",1571,1567,3138,0,65
2012-02-14 07:11:05.000,"Mike Bostock","Mike Bostock",14,6,20,0,46
2012-02-13 21:44:35.000,"Jason Davies","Jason Davies",12,12,24,0,40
2012-02-12 16:41:58.000,"Mike Bostock","Mike Bostock",2,2,4,0,47
2012-02-10 09:16:56.000,"Jason Davies","Jason Davies",3,13,16,0,23
2012-02-09 17:09:23.000,"Mike Bostock","Mike Bostock",27,1,28,0,165
2012-02-09 00:23:40.000,"Jason Davies","Jason Davies",2,2,4,0,50
2012-02-09 00:20:59.000,"Jason Davies","Jason Davies",4,2,6,0,49
2012-02-08 21:46:01.000,"Jason Davies","Jason Davies",2,2,4,0,28
2012-02-07 22:37:18.000,"Trevor Norris","Trevor Norris",11,4,15,0,26
2012-02-07 22:09:39.000,"Trevor Norris","Trevor Norris",10,2,12,0,44
2012-02-03 01:41:35.000,"Mike Bostock","Mike Bostock",434,538,972,5,1546
2012-02-02 04:07:45.000,"Mike Bostock","Mike Bostock",336,76,412,0,22
2012-02-02 04:06:44.000,"Mike Bostock","Mike Bostock",282,48,330,0,119
2012-01-30 03:23:14.000,"Mike Bostock","Mike Bostock",98,4,102,0,46
2012-01-29 22:27:41.000,"Mike Bostock","Mike Bostock",51,25,76,0,146
2012-01-29 21:44:48.000,"Mike Bostock","Mike Bostock",11,7,18,0,56
2012-01-29 21:28:49.000,"Mike Bostock","Mike Bostock",151,26,177,0,355
2012-01-29 18:43:22.000,"Mike Bostock","Mike Bostock",24,13,37,0,86
2012-01-26 19:58:40.000,"Mike Bostock","Mike Bostock",4,1,5,0,32
2012-01-26 19:18:42.000,"Mike Bostock","Mike Bostock",307,5433,5740,0,20
2012-01-26 19:05:06.000,"Mike Bostock","Mike Bostock",6,5,11,2,70
2012-01-26 19:02:17.000,"Mike Bostock","Mike Bostock",2,3,5,0,65
2012-01-26 19:01:52.000,"Mike Bostock","Mike Bostock",5,5,10,0,65
2012-01-26 18:48:32.000,"Mike Bostock","Mike Bostock",17,35,52,0,78
2012-01-26 16:29:26.000,"Nathan Vander Wilt","Nathan Vander Wilt",6,6,12,0,53
2012-01-26 00:20:08.000,"Jason Davies","Jason Davies",8,4,12,0,33
2012-01-26 08:16:44.000,"Mike Bostock","Mike Bostock",3,3,6,0,167
2012-01-25 17:23:38.000,"Jason Davies","Jason Davies",17,35,52,0,39
2012-01-24 17:04:46.000,"Nathan Vander Wilt","Nathan Vander Wilt",142,46,188,0,97
2012-01-24 05:43:11.000,"Nathan Vander Wilt","Nathan Vander Wilt",26,10,36,0,51
2012-01-24 02:15:52.000,"Mike Bostock","Mike Bostock",236,5374,5610,0,39
2012-01-23 23:23:10.000,"Mike Bostock","Mike Bostock",3,3,6,0,31
2012-01-23 23:02:18.000,"Mike Bostock","Mike Bostock",7,7,14,0,30
2012-01-23 21:35:08.000,"Andrew Sutherland","Andrew Sutherland",5,5,10,0,26
2012-01-23 20:45:10.000,"Andrew Sutherland","Andrew Sutherland",4,4,8,0,21
2012-01-23 02:43:23.000,"Jim Radford","Jim Radford",2,3,5,0,24
2012-01-22 18:12:41.000,"Mike Bostock","Mike Bostock",7,3,10,0,30
2012-01-19 20:48:21.000,"Lars Kotthoff","Lars Kotthoff",1,1,2,0,34
2011-10-30 11:12:25.000,"Lars Kotthoff","Lars Kotthoff",46,4,50,0,66
2011-10-29 23:34:11.000,"Lars Kotthoff","Lars Kotthoff",11,4,15,0,58
2011-10-11 19:48:43.000,"Lars Kotthoff","Lars Kotthoff",1,1,2,0,22
2011-10-11 19:43:22.000,"Lars Kotthoff","Lars Kotthoff",1,1,2,0,79
2011-10-04 20:01:52.000,"Lars Kotthoff","Lars Kotthoff",5,0,5,0,37
2011-10-01 15:27:25.000,"Lars Kotthoff","Lars Kotthoff",1,1,2,0,153
2012-01-18 21:10:00.000,"Mike Bostock","Mike Bostock",34,8,42,0,57
2012-01-17 21:08:48.000,"Mike Bostock","Mike Bostock",1,4,5,0,47
2012-01-17 21:07:17.000,"Mike Bostock","Mike Bostock",86,42,128,0,22
2012-01-17 21:02:19.000,"Mike Bostock","Mike Bostock",39,29,68,1,552
2012-01-17 18:39:56.000,"Mike Bostock","Mike Bostock",3,3,6,0,70
2012-01-13 17:13:40.000,"Mike Bostock","Mike Bostock",1,4,5,0,82
2012-01-13 13:16:14.000,"Jason Davies","Jason Davies",1,4,5,0,33
2012-01-09 08:41:36.000,"Jason Davies","Jason Davies",15,15,30,0,52
2012-01-09 08:39:57.000,"Jason Davies","Jason Davies",26,26,52,0,47
2012-01-09 08:35:57.000,"Jason Davies","Jason Davies",12,12,24,0,45
2012-01-09 01:32:12.000,"Jason Davies","Jason Davies",119,61,180,0,50
2012-01-02 00:58:38.000,"Mike Bostock","Mike Bostock",25,1,26,0,98
2012-01-01 20:15:22.000,"Mike Bostock","Mike Bostock",18,8,26,0,39
2012-01-01 19:44:49.000,"Mike Bostock","Mike Bostock",10,0,10,0,28
2011-12-31 09:28:42.000,"Jason Davies","Jason Davies",3,3,6,0,198
2011-12-30 20:00:45.000,"Mike Bostock","Mike Bostock",155,79,234,0,20
2011-12-30 19:58:51.000,"Mike Bostock","Mike Bostock",15,7,22,0,70
2011-12-30 19:58:36.000,"Mike Bostock","Mike Bostock",13,3,16,0,70
2011-12-30 19:57:46.000,"Mike Bostock","Mike Bostock",37,15,52,0,66
2011-12-30 19:57:32.000,"Mike Bostock","Mike Bostock",12,4,16,0,75
2011-12-30 19:56:59.000,"Mike Bostock","Mike Bostock",47,24,71,0,82
2011-12-30 19:24:59.000,"Mike Bostock","Mike Bostock",18,14,32,0,65
2011-12-30 19:16:49.000,"Mike Bostock","Mike Bostock",8,7,15,0,45
2011-12-30 19:05:52.000,"Mike Bostock","Mike Bostock",9,9,18,0,31
2011-12-30 18:41:40.000,"Jason Davies","Jason Davies",8,4,12,0,134
2011-12-28 11:41:55.000,"Jason Davies","Jason Davies",4,4,8,0,27
2011-12-27 18:08:22.000,"Mike Bostock","Mike Bostock",18,14,32,0,31
2011-12-27 17:59:12.000,"Mike Bostock","Mike Bostock",0,0,0,0,72
2011-12-27 10:24:46.000,"Ger Hobbelt","Ger Hobbelt",4,4,8,0,267
2011-12-27 08:32:15.000,"Andy Chong","Andy Chong",1,1,2,0,148
2011-12-20 22:22:01.000,"Gerard Hundman","Gerard Hundman",8,4,12,0,122
2011-12-20 16:39:01.000,"Mike Bostock","Mike Bostock",1,1,2,0,100
2011-12-15 19:07:12.000,"Jason Davies","Jason Davies",13,13,26,0,63
2011-12-15 17:55:03.000,"Jason Davies","Jason Davies",46,13,59,0,62
2011-12-14 09:27:58.000,"Jason Davies","Jason Davies",2,0,2,0,45
2011-12-14 09:21:15.000,"Jason Davies","Jason Davies",12,12,24,0,37
2011-12-14 09:15:25.000,"Jason Davies","Jason Davies",15,9,24,0,48
2011-12-13 14:43:15.000,"Jason Davies","Jason Davies",2,2,4,0,23
2011-12-13 13:40:46.000,"Jason Davies","Jason Davies",1,1,2,0,23
2011-12-13 13:39:36.000,"Jason Davies","Jason Davies",11,19,30,0,34
2011-12-13 13:32:51.000,"Jason Davies","Jason Davies",35,5,40,0,63
2011-12-13 12:43:37.000,"Jason Davies","Jason Davies",13,3,16,0,154
2011-12-11 02:24:09.000,"Mike Bostock","Mike Bostock",9,9,18,0,22
2011-12-10 09:42:12.000,"Jason Davies","Jason Davies",13,9,22,0,366
2011-12-09 02:06:31.000,"Mike Bostock","Mike Bostock",137,30,167,0,20
2011-12-09 01:55:46.000,"Mike Bostock","Mike Bostock",1,0,1,0,18
2011-12-09 01:54:31.000,"Mike Bostock","Mike Bostock",15,2,17,0,79
2011-12-09 01:49:22.000,"Mike Bostock","Mike Bostock",37,8,45,0,50
2011-12-09 01:14:08.000,"Mike Bostock","Mike Bostock",83,19,102,0,149
2011-12-07 00:07:45.000,"Nathan Vander Wilt","Nathan Vander Wilt",15,2,17,0,47
2011-11-30 05:57:58.000,"Mike Bostock","Mike Bostock",535,529,1064,0,22
2011-11-30 05:57:20.000,"Mike Bostock","Mike Bostock",10,8,18,0,50
2011-11-30 05:56:46.000,"Mike Bostock","Mike Bostock",7,3,10,0,45
2011-11-30 05:55:51.000,"Mike Bostock","Mike Bostock",10,8,18,0,40
2011-11-30 05:36:51.000,"Mike Bostock","Mike Bostock",7,3,10,0,9
2011-11-23 22:54:09.000,"Jason Davies","Jason Davies",20,20,40,0,47
2011-11-23 22:46:37.000,"Jason Davies","Jason Davies",498,498,996,0,47
2011-11-23 21:04:39.000,"Mike Bostock","Mike Bostock",7,7,14,0,28
2011-11-23 21:00:39.000,"Mike Bostock","Mike Bostock",603,225,828,0,22
2011-11-23 20:59:49.000,"Mike Bostock","Mike Bostock",41,2,43,0,37
2011-11-23 20:59:31.000,"Mike Bostock","Mike Bostock",341,117,458,0,40
2011-11-23 20:59:06.000,"Mike Bostock","Mike Bostock",181,75,256,0,32
2011-11-23 20:52:56.000,"Mike Bostock","Mike Bostock",31,30,61,0,267
2011-11-23 20:44:49.000,"Mike Bostock","Mike Bostock",8686,1910,10596,0,44
2011-11-23 20:44:04.000,"Mike Bostock","Mike Bostock",41,2,43,0,14
2011-11-23 20:30:49.000,"Mike Bostock","Mike Bostock",134,26,160,0,228
2011-11-23 20:05:52.000,"Mike Bostock","Mike Bostock",211,95,306,0,24
2011-11-22 22:38:43.000,"Mike Bostock","Mike Bostock",127,133,260,0,27
2011-11-22 22:36:09.000,"Mike Bostock","Mike Bostock",107,121,228,0,188
2011-11-22 21:08:55.000,"Mike Bostock","Mike Bostock",22,14,36,0,602
2011-11-19 00:52:35.000,"Mike Bostock","Mike Bostock",4,0,4,0,15
2011-11-16 21:55:11.000,"Mike Bostock","Mike Bostock",136,26,162,0,22
2011-11-16 21:54:20.000,"Mike Bostock","Mike Bostock",121,16,137,0,37
2011-11-16 21:53:28.000,"Mike Bostock","Mike Bostock",25,16,41,0,30
2011-11-16 21:45:28.000,"Mike Bostock","Mike Bostock",6,10,16,0,22
2011-11-16 21:23:33.000,"Jason Davies","Jason Davies",1,1,2,0,13
2011-11-16 21:16:14.000,"Jason Davies","Jason Davies",115,12,127,0,214
2011-11-16 01:17:05.000,"Mike Bostock","Mike Bostock",4,2,6,0,36
2011-11-16 01:16:26.000,"Mike Bostock","Mike Bostock",25,16,41,0,31
2011-11-15 00:07:11.000,"Mike Bostock","Mike Bostock",16,10,26,0,195
2011-11-14 15:59:11.000,"Mike Bostock","Mike Bostock",11,11,22,0,47
2011-11-14 02:28:09.000,"Mike Bostock","Mike Bostock",14,5,19,0,42
2011-11-10 23:46:07.000,"Mike Bostock","Mike Bostock",60,48,108,0,308
2011-11-10 23:16:46.000,"Mike Bostock","Mike Bostock",139,47,186,0,335
2011-11-10 20:35:09.000,"Mike Bostock","Mike Bostock",8,3,11,0,79
2011-11-10 20:31:54.000,"Mike Bostock","Mike Bostock",7,7,14,0,25
2011-11-09 19:29:27.000,"Mike Bostock","Mike Bostock",11,11,22,0,109
2011-11-05 01:53:22.000,"Jason Davies","Jason Davies",11,11,22,0,230
2011-11-05 02:42:59.000,"Mike Bostock","Mike Bostock",6,6,12,0,40
2011-11-05 02:36:50.000,"Mike Bostock","Mike Bostock",2310,411,2721,0,20
2011-11-05 02:06:43.000,"Mike Bostock","Mike Bostock",197,18,215,0,35
2011-11-05 02:05:06.000,"Mike Bostock","Mike Bostock",60,0,60,0,33
2011-11-05 02:03:17.000,"Mike Bostock","Mike Bostock",8,10,18,0,31
2011-11-05 01:08:53.000,"Mike Bostock","Mike Bostock",4,4,8,0,74
2011-11-04 23:46:35.000,"Mike Bostock","Mike Bostock",28,14,42,0,44
2011-11-04 23:19:58.000,"Mike Bostock","Mike Bostock",113,6,119,0,196
2011-11-04 22:14:06.000,"Mike Bostock","Mike Bostock",52,52,104,0,16
2011-11-04 22:13:44.000,"Mike Bostock","Mike Bostock",7,3,10,0,74
2011-11-04 22:12:05.000,"Jason Davies","Jason Davies",4,4,8,0,141
2011-11-04 22:01:55.000,"Jason Davies","Jason Davies",7,3,10,0,49
2011-11-04 21:10:01.000,"Mike Bostock","Mike Bostock",6,20,26,0,36
2011-11-04 20:48:56.000,"Mike Bostock","Mike Bostock",1,1,2,0,44
2011-11-04 20:41:02.000,"Mike Bostock","Mike Bostock",18,10,28,0,74
2011-11-04 20:39:06.000,"Mike Bostock","Mike Bostock",5,11,16,0,20
2011-11-04 20:38:13.000,"Jason Davies","Jason Davies",18,10,28,0,22
2011-11-04 20:35:09.000,"Jason Davies","Jason Davies",3,3,6,0,35
2011-11-04 20:32:14.000,"Mike Bostock","Mike Bostock",3,3,6,0,14
2011-11-04 20:25:45.000,"Jason Davies","Jason Davies",2078,404,2482,0,113
2011-11-04 20:22:27.000,"Jason Davies","Jason Davies",3,3,6,0,46
2011-11-04 20:19:14.000,"Jason Davies","Jason Davies",8,8,16,0,23
2011-11-04 20:18:19.000,"Mike Bostock","Mike Bostock",14,10,24,0,73
2011-11-04 20:18:18.000,"Jason Davies","Jason Davies",4,26,30,0,137
2011-11-04 20:14:20.000,"Jason Davies","Jason Davies",14,12,26,0,119
2011-11-04 19:41:42.000,"Mike Bostock","Mike Bostock",104,34,138,0,73
2011-11-04 19:03:01.000,"Mike Bostock","Mike Bostock",21,12,33,0,251
2011-11-04 18:28:27.000,"Mike Bostock","Mike Bostock",19,12,31,0,42
2011-11-04 00:04:02.000,"Mike Bostock","Mike Bostock",41,6,47,0,79
2011-11-04 00:02:19.000,"Mike Bostock","Mike Bostock",70,61,131,0,47
2011-11-03 17:34:02.000,"Jason Davies","Jason Davies",15,23,38,0,133
2011-11-03 16:59:41.000,"Jason Davies","Jason Davies",102,6,108,0,32
2011-11-03 16:20:06.000,"Mike Bostock","Mike Bostock",57,5,62,0,113
2011-11-03 16:06:04.000,"Mike Bostock","Mike Bostock",1,0,1,0,28
2011-11-02 23:19:37.000,"Mike Bostock","Mike Bostock",562,6,568,0,191
2011-11-02 18:44:29.000,"Mike Bostock","Mike Bostock",152,152,304,0,512
2011-11-02 16:18:57.000,"Mike Bostock","Mike Bostock",1,1,2,0,85
2011-11-02 12:32:50.000,"Jason Davies","Jason Davies",1,1,2,0,31
2011-11-02 02:14:12.000,"Mike Bostock","Mike Bostock",106,64,170,0,44
2011-11-02 01:08:54.000,"Mike Bostock","Mike Bostock",88,25,113,0,84
2011-11-01 23:53:09.000,"Mike Bostock","Mike Bostock",301,168,469,0,320
2011-11-01 20:30:58.000,"Mike Bostock","Mike Bostock",189,82,271,0,230
2011-11-01 18:57:37.000,"Mike Bostock","Mike Bostock",112,92,204,0,17
2011-11-01 01:03:48.000,"Mike Bostock","Mike Bostock",118,22,140,0,95
2011-10-31 23:59:17.000,"Mike Bostock","Mike Bostock",529,19,548,0,253
2011-10-29 18:50:09.000,"Mike Bostock","Mike Bostock",16,14,30,0,70
2011-10-29 18:42:19.000,"Mike Bostock","Mike Bostock",153,136,289,0,172
2011-10-29 17:39:52.000,"Mike Bostock","Mike Bostock",22,2,24,0,53
2011-10-29 01:11:20.000,"Mike Bostock","Mike Bostock",2,0,2,0,47
2011-10-29 01:05:50.000,"Mike Bostock","Mike Bostock",31,32,63,0,29
2011-10-29 01:04:03.000,"Mike Bostock","Mike Bostock",31,32,63,0,49
2011-10-29 00:53:58.000,"Mike Bostock","Mike Bostock",3,3,6,0,42
2011-10-29 00:48:03.000,"Mike Bostock","Mike Bostock",2,3,5,0,36
2011-10-29 00:47:31.000,"Mike Bostock","Mike Bostock",2,2,4,0,20
2011-10-18 21:30:20.000,"Johan Sundström","Mike Bostock",2,3,5,0,45
2011-10-29 00:29:23.000,"Mike Bostock","Mike Bostock",13,8,21,0,26
2011-10-29 00:15:07.000,"Mike Bostock","Mike Bostock",2,1,3,0,75
2011-10-25 09:54:19.000,"Jason Davies","Jason Davies",8,10,18,0,85
2011-10-25 09:52:00.000,"Jason Davies","Jason Davies",8,12,20,0,194
2011-10-25 09:30:59.000,"Jason Davies","Jason Davies",14,6,20,0,190
2011-10-25 09:12:42.000,"Jason Davies","Jason Davies",3,3,6,0,176
2011-10-24 03:39:40.000,"Mike Bostock","Mike Bostock",13,9,22,0,253
2011-10-20 15:54:24.000,"Jason Davies","Jason Davies",4,4,8,0,14
2011-10-20 15:52:06.000,"Jason Davies","Jason Davies",10,10,20,0,38
2011-10-20 15:27:02.000,"Jason Davies","Jason Davies",16,12,28,0,38
2011-10-20 13:15:57.000,"Jason Davies","Jason Davies",86,62,148,0,369
2011-09-22 15:17:23.000,"Jason Davies","Jason Davies",65,15,80,0,430
2011-10-20 02:01:39.000,"Mike Bostock","Mike Bostock",15,15,30,0,56
2011-10-20 01:57:53.000,"Mike Bostock","Mike Bostock",46,41,87,0,198
2011-10-19 22:23:14.000,"Mike Bostock","Mike Bostock",3,3,6,0,22
2011-10-17 18:27:57.000,"Mike Bostock","Mike Bostock",52,52,104,0,16
2011-10-17 17:54:11.000,"Mike Bostock","Mike Bostock",61,28,89,0,39
2011-10-17 08:43:27.000,"Jason Davies","Jason Davies",2,2,4,0,22
2011-10-14 21:45:16.000,"Mike Bostock","Mike Bostock",63,24,87,0,409
2011-10-10 08:27:24.000,"Jason Davies","Jason Davies",15,15,30,0,123
2011-10-13 08:30:45.000,"Mike Bostock","Mike Bostock",223,0,223,0,35
2011-10-13 01:55:08.000,"Mike Bostock","Mike Bostock",91,134,225,0,30
2011-10-12 23:37:32.000,"Mike Bostock","Mike Bostock",61,19,80,0,177
2011-10-12 22:02:57.000,"Mike Bostock","Mike Bostock",121,1,122,0,41
2011-10-12 02:02:06.000,"Mike Bostock","Mike Bostock",93,22,115,0,22
2011-10-12 02:01:43.000,"Mike Bostock","Mike Bostock",26,8,34,0,32
2011-10-12 02:01:25.000,"Mike Bostock","Mike Bostock",26,8,34,0,66
2011-10-12 01:46:13.000,"Mike Bostock","Mike Bostock",64,11,75,0,338
2011-10-12 00:46:47.000,"Mike Bostock","Mike Bostock",164,29,193,0,191
2011-10-11 09:06:38.000,"Jason Davies","Jason Davies",20,6,26,0,49
2011-10-11 05:40:52.000,"Mike Bostock","Mike Bostock",83,0,83,0,26
2011-10-11 05:40:10.000,"Mike Bostock","Mike Bostock",364,91,455,0,22
2011-10-11 05:39:00.000,"Mike Bostock","Mike Bostock",115,37,152,0,37
2011-10-11 05:38:26.000,"Mike Bostock","Mike Bostock",60,3,63,0,36
2011-10-11 05:37:56.000,"Mike Bostock","Mike Bostock",134,2,136,0,32
2011-10-11 05:13:25.000,"Mike Bostock","Mike Bostock",104,148,252,3,233
2011-10-11 01:54:46.000,"Mike Bostock","Mike Bostock",132,10,142,0,80
2011-10-11 01:50:17.000,"Mike Bostock","Mike Bostock",60,3,63,0,79
2011-10-11 01:49:53.000,"Mike Bostock","Mike Bostock",67,6,73,0,14
2011-10-11 01:41:52.000,"Mike Bostock","Mike Bostock",73,2,75,0,66
2011-10-11 00:45:08.000,"Mike Bostock","Mike Bostock",55,49,104,0,265
2011-10-08 18:19:01.000,"Jason Davies","Jason Davies",41,18,59,0,173
2011-10-08 17:30:17.000,"Jason Davies","Jason Davies",37,3,40,0,519
2011-10-08 17:45:47.000,"Mike Bostock","Mike Bostock",7,6,13,0,66
2011-10-08 13:58:41.000,"Jason Davies","Jason Davies, working on the server",1,0,1,0,278
2011-10-08 12:42:45.000,"Jason Davies","Jason Davies",2,2,4,0,47
2011-10-08 00:09:59.000,"Jason Davies","Jason Davies",4,4,8,0,174
2011-10-07 23:37:51.000,"Mike Bostock","Mike Bostock",17,13,30,0,37
2011-10-07 21:57:59.000,"Jason Davies","Jason Davies",62,2,64,0,68
2011-10-07 20:23:55.000,"Mike Bostock","Mike Bostock",311,183,494,0,22
2011-10-07 20:19:30.000,"Mike Bostock","Mike Bostock",28,22,50,0,11
2011-10-07 20:18:33.000,"Mike Bostock","Mike Bostock",53,4,57,0,72
2011-10-07 20:17:17.000,"Mike Bostock","Mike Bostock",96,34,130,0,127
2011-10-07 20:16:15.000,"Mike Bostock","Mike Bostock",33,22,55,0,49
2011-10-07 20:10:10.000,"Mike Bostock","Mike Bostock",10,6,16,0,344
2011-10-07 19:32:06.000,"Mike Bostock","Mike Bostock",33,22,55,0,250
2011-10-07 17:40:58.000,"Jason Davies","Jason Davies",93,98,191,0,128
2011-10-06 20:34:06.000,"Jason Davies","Jason Davies",13,13,26,0,189
2011-10-06 20:06:14.000,"Jason Davies","Jason Davies",61,49,110,0,84
2011-10-06 16:45:49.000,"Mike Bostock","Mike Bostock",13,16,29,0,93
2011-10-06 09:56:34.000,"Jason Davies","Jason Davies",6,6,12,0,19
2011-10-06 09:54:07.000,"Jason Davies","Jason Davies",49,31,80,0,68
2011-10-05 23:05:42.000,"Jason Davies","Jason Davies",14,13,27,0,47
2011-10-05 22:38:30.000,"Jason Davies","Jason Davies",3,3,6,0,35
2011-10-05 22:35:19.000,"Jason Davies","Jason Davies",36,5,41,0,43
2011-10-04 19:34:16.000,"Lars Kotthoff","Lars Kotthoff",13,21,34,0,55
2011-10-03 21:07:38.000,"Lars Kotthoff","Lars Kotthoff",6,1,7,0,523
2011-10-03 19:49:44.000,"Lars Kotthoff","Lars Kotthoff",2,1,3,0,237
2011-10-01 02:00:42.000,"Mike Bostock","Mike Bostock",661,0,661,0,23
2011-09-30 17:01:24.000,"Mike Bostock","Mike Bostock",661,0,661,0,22
2011-09-30 17:02:11.000,"Mike Bostock","Mike Bostock",22,2,24,0,91
2011-09-30 17:00:55.000,"Mike Bostock","Mike Bostock",4,0,4,0,106
2011-09-30 16:55:30.000,"Jason Davies","Jason Davies",4,0,4,0,113
2011-09-30 08:48:28.000,"Jason Davies","Jason Davies",2,3,5,0,9
2011-09-30 08:43:22.000,"Jason Davies","Jason Davies",23,2,25,0,116
2011-09-30 07:51:33.000,"Jason Davies","Jason Davies",17,23,40,0,35
2011-09-30 05:53:22.000,"Mike Bostock","Mike Bostock",125,111,236,0,37
2011-09-29 22:59:56.000,"Mike Bostock","Mike Bostock",15,11,26,2,43
2011-09-29 16:33:34.000,"Jason Davies","Jason Davies",5,7,12,0,44
2011-09-28 21:10:59.000,"Jason Davies","Jason Davies",61,4,65,0,58
2011-09-28 23:28:36.000,"Mike Bostock","Mike Bostock",70,0,70,0,99
2011-09-27 23:00:27.000,"Mike Bostock","Mike Bostock",1649,618,2267,0,22
2011-09-27 22:58:39.000,"Mike Bostock","Mike Bostock",161,84,245,0,40
2011-09-27 21:57:56.000,"Mike Bostock","Mike Bostock",340,1,341,0,70
2011-09-27 21:56:18.000,"Mike Bostock","Mike Bostock",1122,572,1694,0,36
2011-09-27 21:56:07.000,"Mike Bostock","Mike Bostock",5,4,9,0,50
2011-09-27 21:55:35.000,"Mike Bostock","Mike Bostock",64,21,85,0,43
2011-09-27 21:54:58.000,"Mike Bostock","Mike Bostock",3,1,4,0,45
2011-09-27 21:54:36.000,"Mike Bostock","Mike Bostock",26,10,36,0,79
2011-09-27 21:45:34.000,"Mike Bostock","Mike Bostock",7,3,10,0,29
2011-09-27 21:53:17.000,"Mike Bostock","Mike Bostock",5,4,9,0,65
2011-09-27 21:53:05.000,"Mike Bostock","Mike Bostock",6,8,14,0,78
2011-09-27 20:27:17.000,"Mike Bostock","Mike Bostock",83,15,98,0,29
2011-09-27 20:14:06.000,"Mike Bostock","Mike Bostock",29,39,68,0,38
2011-09-27 20:13:40.000,"Mike Bostock","Mike Bostock",54,1,55,0,83
2011-09-27 20:06:48.000,"Mike Bostock","Mike Bostock",3,3,6,0,38
2011-09-27 20:06:23.000,"Mike Bostock","Mike Bostock",6,6,12,0,48
2011-09-27 19:55:47.000,"Mike Bostock","Mike Bostock",191,250,441,0,299
2011-09-27 16:58:52.000,"Mike Bostock","Mike Bostock",261,244,505,0,177
2011-09-27 16:47:14.000,"Mike Bostock","Mike Bostock",55,11,66,0,22
2011-09-27 16:45:06.000,"Mike Bostock","Mike Bostock",54,10,64,0,244
2011-09-27 16:26:41.000,"Mike Bostock","Mike Bostock",4,4,8,0,69
2011-09-27 08:51:00.000,"Mike Bostock","Mike Bostock",3,3,6,0,38
2011-09-27 08:34:22.000,"Mike Bostock","Mike Bostock",547,556,1103,0,488
2011-09-27 08:31:22.000,"Mike Bostock","Mike Bostock",1,1,2,0,91
2011-09-27 00:36:46.000,"Mike Bostock","Mike Bostock",607,117,724,0,74
2011-09-26 13:20:04.000,"Jason Davies","Jason Davies",6,8,14,0,168
2011-09-26 02:37:51.000,"Jason Davies","Jason Davies",71,7,78,0,59
2011-09-25 23:40:28.000,"Jason Davies","Jason Davies",276,1,277,0,199
2011-09-24 23:47:06.000,"Johan Sundström","Johan Sundström",5,4,9,0,58
2011-09-22 23:50:30.000,"Jason Davies","Jason Davies",7,7,14,0,49
2011-09-22 23:22:08.000,"Jason Davies","Jason Davies",32,16,48,0,583
2011-09-21 23:32:19.000,"Mike Bostock","Mike Bostock",64,21,85,4,307
2011-09-21 18:10:47.000,"Mike Bostock","Mike Bostock",20,5,25,0,47
2011-09-21 18:08:39.000,"Mike Bostock","Mike Bostock",13,14,27,0,269
2011-09-21 02:14:00.000,"Peter Woodman","Peter Woodman",2,1,3,0,48
2011-09-21 01:23:55.000,"Peter Woodman","Peter Woodman",5,3,8,0,85
2011-09-21 01:10:42.000,"Peter Woodman","Peter Woodman",7,7,14,0,117
2011-09-21 00:38:52.000,"Mike Bostock","Mike Bostock",3,4,7,0,37
2011-09-21 00:20:06.000,"Peter Woodman","Peter Woodman",127,10,137,0,37
2011-09-20 11:05:09.000,"Peter Woodman","Peter Woodman",2,0,2,0,81
2011-09-20 20:19:04.000,"Mike Bostock","Mike Bostock",3,1,4,0,110
2011-09-19 09:18:35.000,"Jason Davies","Jason Davies",4,4,8,0,542
2011-09-18 13:43:24.000,"Jason Davies","Jason Davies",15,0,15,0,32
2011-09-18 10:46:32.000,"Jason Davies","Jason Davies",5,5,10,0,232
2011-09-18 04:35:40.000,"Mike Bostock","Mike Bostock",453,128,581,0,22
2011-09-18 04:32:04.000,"Mike Bostock","Mike Bostock",53,38,91,0,38
2011-09-18 04:09:00.000,"Mike Bostock","Mike Bostock",24,13,37,0,67
2011-09-18 04:07:56.000,"Mike Bostock","Mike Bostock",38,4,42,0,72
2011-09-18 04:05:09.000,"Mike Bostock","Mike Bostock",85,27,112,0,69
2011-09-18 03:17:09.000,"Mike Bostock","Mike Bostock",18,42,60,0,97
2011-09-18 03:04:02.000,"Mike Bostock","Mike Bostock",138,22,160,0,83
2011-09-18 03:03:16.000,"Mike Bostock","Mike Bostock",26,34,60,0,41
2011-09-18 03:02:34.000,"Mike Bostock","Mike Bostock",124,27,151,0,45
2011-09-15 19:03:28.000,"Lars Kotthoff","Lars Kotthoff",26,0,26,0,30
2011-09-15 01:15:38.000,"yasirs","yasirs",7,7,14,0,29
2011-09-15 01:13:31.000,"yasirs","yasirs",4,4,8,0,55
2011-09-14 22:08:25.000,"yasirs","yasirs",1,5,6,0,44
2011-09-14 22:04:48.000,"yasirs","yasirs",2,3,5,0,27
2011-09-14 22:01:08.000,"yasirs","yasirs",15,7,22,0,28
2011-09-14 21:54:40.000,"yasirs","yasirs",3,3,6,0,33
2011-09-14 21:47:07.000,"yasirs","yasirs",4,3,7,0,38
2011-09-14 21:38:46.000,"yasirs","yasirs",8,14,22,0,179
2011-09-14 21:23:53.000,"yasirs","yasirs",8,4,12,0,17
2011-09-14 21:17:30.000,"yasirs","yasirs",13,10,23,0,28
2011-09-14 19:58:18.000,"yasirs","yasirs",9,3,12,0,63
2011-09-14 19:15:50.000,"Mike Bostock","Mike Bostock",26,34,60,0,18
2011-09-12 17:32:36.000,"Jason Davies","Jason Davies",30,12,42,0,109
2011-09-12 17:23:32.000,"Jason Davies","Jason Davies",61,61,122,0,68
2011-09-12 15:23:30.000,"Jason Davies","Jason Davies",63,59,122,0,192
2011-09-12 14:10:45.000,"Jason Davies","Jason Davies",5,7,12,0,108
2011-09-12 13:47:23.000,"Jason Davies","Jason Davies",2,2,4,0,44
2011-09-12 13:45:04.000,"Jason Davies","Jason Davies",54,14,68,0,42
2011-09-12 13:14:37.000,"Jason Davies","Jason Davies",59,61,120,0,109
2011-09-12 11:53:37.000,"Jason Davies","Jason Davies",163,119,282,0,477
2011-09-12 10:56:24.000,"Jason Davies","Jason Davies",11,9,20,0,49
2011-09-12 10:21:54.000,"Jason Davies","Jason Davies",5,9,14,0,43
2011-09-10 15:37:39.000,"Jason Davies","Jason Davies",264,26,290,0,441
2011-09-12 01:36:16.000,"Mike Bostock","Mike Bostock",1,1,2,0,37
2011-09-10 13:42:45.000,"Jason Davies","Jason Davies",46,4,50,0,42
2011-09-10 13:34:19.000,"Jason Davies","Jason Davies",59,7,66,0,42
2011-09-10 12:50:08.000,"Jason Davies","Jason Davies",69,11,80,0,87
2011-09-09 23:41:35.000,"Mike Bostock","Mike Bostock",805,3,808,0,100
2011-09-09 23:37:59.000,"Jason Davies","Jason Davies",805,3,808,0,50
2011-09-09 08:20:55.000,"Jason Davies","Jason Davies",3,3,6,0,45
2011-09-08 09:12:38.000,"Jason Davies","Jason Davies",11,0,11,0,45
2011-09-08 09:04:13.000,"Jason Davies","Jason Davies",10,0,10,0,43
2011-09-08 09:00:24.000,"Jason Davies","Jason Davies",39,0,39,0,49
2011-09-08 07:09:51.000,"Jason Davies","Jason Davies",56,21,77,0,112
2011-09-08 00:26:44.000,"Jason Davies","Jason Davies",26,5,31,0,62
2011-09-07 08:55:37.000,"Jason Davies","Jason Davies",7,5,12,0,19
2011-09-03 22:23:08.000,"Jason Davies","Jason Davies",17,5,22,0,39
2011-09-03 21:48:19.000,"Jason Davies","Jason Davies",7,7,14,0,19
2011-09-02 19:57:59.000,"Mike Bostock","Mike Bostock",6,6,12,0,78
2011-09-02 11:52:24.000,"Jason Davies","Jason Davies",75,25,100,0,102
2011-09-01 01:50:48.000,"Mike Bostock","Mike Bostock",58,46,104,0,22
2011-09-01 01:50:07.000,"Mike Bostock","Mike Bostock",48,36,84,0,38
2011-08-31 12:48:01.000,"Jason Davies","Jason Davies",10,10,20,0,38
2011-08-30 21:07:41.000,"Mike Bostock","Mike Bostock",48,36,84,0,321
2011-08-30 00:38:12.000,"Mike Bostock","Mike Bostock",109,0,109,0,32
2011-08-29 20:13:19.000,"Mike Bostock","Mike Bostock",6,6,12,0,38
2011-08-29 19:58:09.000,"Mike Bostock","Mike Bostock",2,2,4,0,47
2011-08-29 19:56:58.000,"Mike Bostock","Mike Bostock",656,124,780,0,22
2011-08-29 19:54:21.000,"Mike Bostock","Mike Bostock",280,9,289,0,75
2011-08-29 19:53:22.000,"Mike Bostock","Mike Bostock",226,1,227,0,76
2011-08-29 19:52:45.000,"Mike Bostock","Mike Bostock",28,19,47,0,37
2011-08-29 19:52:22.000,"Mike Bostock","Mike Bostock",6,6,12,0,44
2011-08-29 19:51:58.000,"Mike Bostock","Mike Bostock",61,41,102,0,51
2011-08-29 19:51:27.000,"Mike Bostock","Mike Bostock",55,48,103,0,33
2011-08-29 18:03:31.000,"Jason Davies","Jason Davies",37,37,74,0,48
2011-08-29 16:46:58.000,"Mike Bostock","Mike Bostock",2,2,4,0,98
2011-08-29 01:33:17.000,"Jason Davies","Jason Davies",125,56,181,0,221
2011-08-29 11:40:56.000,"Jason Davies","Jason Davies",2,2,4,0,280
2011-08-29 03:35:53.000,"Mike Bostock","Mike Bostock",28,19,47,1,473
2011-08-29 02:28:22.000,"Mike Bostock","Mike Bostock",5,5,10,0,217
2011-08-29 01:10:52.000,"Mike Bostock","Mike Bostock",5,5,10,0,43
2011-08-28 23:20:58.000,"Mike Bostock","Mike Bostock",61,41,102,0,251
2011-08-28 17:32:52.000,"Mike Bostock","Mike Bostock",43,39,82,0,529
2011-08-28 16:59:35.000,"Jason Davies","Jason Davies",157,1,158,0,414
2011-08-27 19:49:32.000,"Mike Bostock","Mike Bostock",23,20,43,0,385
2011-08-27 19:38:03.000,"Mike Bostock","Mike Bostock",13,5,18,0,110
2011-08-27 18:59:24.000,"Mike Bostock","Mike Bostock",1,1,2,0,84
2011-08-27 18:54:50.000,"Jason Davies","Jason Davies",18,18,36,0,50
2011-08-27 18:48:47.000,"Jason Davies","Jason Davies",3,3,6,0,43
2011-08-27 18:45:26.000,"Jason Davies","Jason Davies",19,19,38,0,168
2011-08-27 12:00:27.000,"Jason Davies","Jason Davies",278,7,285,0,80
2011-08-27 01:00:23.000,"Mike Bostock","Mike Bostock",195,95,290,0,22
2011-08-27 00:58:45.000,"Mike Bostock","Mike Bostock",114,47,161,0,49
2011-08-27 00:58:15.000,"Mike Bostock","Mike Bostock",37,34,71,0,42
2011-08-27 00:57:34.000,"Mike Bostock","Mike Bostock",10,10,20,0,40
2011-08-27 00:54:12.000,"Mike Bostock","Mike Bostock",35,5,40,0,81
2011-08-27 00:50:29.000,"Mike Bostock","Mike Bostock",114,47,161,0,421
2011-08-26 21:29:21.000,"Jason Davies","Jason Davies",1,1,2,0,153
2011-08-26 21:17:27.000,"Mike Bostock","Mike Bostock",37,34,71,0,265
2011-08-26 18:46:01.000,"Jason Davies","Jason Davies",35,5,40,0,77
2011-08-26 00:36:40.000,"Jason Davies","Jason Davies",23,7,30,0,42
2011-08-25 17:13:45.000,"Mike Bostock","Mike Bostock",10,10,20,0,235
2011-08-25 02:11:35.000,"Mike Bostock","Mike Bostock",12,10,22,0,21
2011-08-25 02:04:29.000,"Mike Bostock","Mike Bostock",274,57,331,0,22
2011-08-25 02:01:13.000,"Mike Bostock","Mike Bostock",3,3,6,0,39
2011-08-25 01:56:34.000,"Mike Bostock","Mike Bostock",181,0,181,0,31
2011-08-25 01:46:10.000,"Mike Bostock","Mike Bostock",16,2,18,0,170
2011-08-25 00:20:59.000,"Mike Bostock","Mike Bostock",9,3,12,0,42
2011-08-25 00:11:28.000,"Mike Bostock","Mike Bostock",33,21,54,0,194
2011-08-25 00:04:47.000,"Mike Bostock","Mike Bostock",34,30,64,0,337
2011-08-24 22:12:59.000,"Mike Bostock","Mike Bostock",96,86,182,0,22
2011-08-24 22:11:52.000,"Mike Bostock","Mike Bostock",8,4,12,0,78
2011-08-24 22:08:19.000,"Mike Bostock","Mike Bostock",88,82,170,0,295
2011-08-24 18:28:14.000,"Jason Davies","Jason Davies",8,4,12,0,43
2011-08-23 21:09:39.000,"Mike Bostock","Mike Bostock",8,1,9,0,76
2011-08-23 20:53:21.000,"Mike Bostock","Mike Bostock",7920,3140,11060,0,22
2011-08-23 20:51:44.000,"Mike Bostock","Mike Bostock",7451,2757,10208,0,32
2011-08-23 20:47:46.000,"Mike Bostock","Mike Bostock",469,383,852,0,327
2011-08-23 20:02:12.000,"Mike Bostock","Mike Bostock",202,215,417,0,413
2011-08-23 19:07:18.000,"Mike Bostock","Mike Bostock",65,41,106,0,47
2011-08-23 18:37:38.000,"Mike Bostock","Mike Bostock",177,45,222,0,17
2011-08-23 17:06:39.000,"Xavier Shay","Xavier Shay",15,1,16,0,37
2011-08-23 17:06:00.000,"Xavier Shay","Xavier Shay",9,8,17,0,48
2011-08-23 16:38:18.000,"Mike Bostock","Mike Bostock",9,0,9,0,16
2011-08-23 11:07:23.000,"Jason Davies","Jason Davies",20,2,22,0,43
2011-08-23 07:01:53.000,"Mike Bostock","Mike Bostock",6,6,12,0,94
2011-08-23 06:53:51.000,"Mike Bostock","Mike Bostock",225,102,327,0,34
2011-08-23 02:50:14.000,"Mike Bostock","Mike Bostock",35,15,50,0,55
2011-08-23 02:05:41.000,"Mike Bostock","Mike Bostock",12,6,18,0,35
2011-08-23 01:28:45.000,"Mike Bostock","Mike Bostock",109,7,116,0,506
2011-08-23 00:35:23.000,"Mike Bostock","Mike Bostock",67,22,89,0,17
2011-08-23 00:20:54.000,"Mike Bostock","Mike Bostock",86,48,134,0,31
2011-08-22 22:20:54.000,"Mike Bostock","Mike Bostock",1,2,3,0,25
2011-08-22 22:08:18.000,"Mike Bostock","Mike Bostock",85,46,131,0,22
2011-08-22 22:05:06.000,"Mike Bostock","Mike Bostock",44,7,51,0,75
2011-08-22 22:03:32.000,"Mike Bostock","Mike Bostock",25,23,48,0,33
2011-08-22 22:03:19.000,"Mike Bostock","Mike Bostock",2,2,4,0,70
2011-08-22 21:48:21.000,"Jason Davies","Jason Davies",44,7,51,0,195
2011-08-22 21:43:41.000,"Mike Bostock","Mike Bostock",15,9,24,0,520
2011-08-22 21:23:26.000,"Jason Davies","Jason Davies",11,11,22,0,21
2011-08-22 20:40:45.000,"Mike Bostock","Mike Bostock",11,15,26,0,272
2011-08-18 20:21:47.000,"Jason Davies","Jason Davies",269,175,444,0,275
2011-08-22 19:33:13.000,"Mike Bostock","Mike Bostock",2,2,4,0,23
2011-08-22 19:26:40.000,"Mike Bostock","Mike Bostock",211,257,468,0,244
2011-08-22 05:07:29.000,"Mike Bostock","Mike Bostock",407,353,760,0,29
2011-08-22 04:34:22.000,"Mike Bostock","Mike Bostock",57,25,82,0,21
2011-08-22 01:50:22.000,"Mike Bostock","Mike Bostock",73,2,75,0,30
2011-08-22 01:43:37.000,"Mike Bostock","Mike Bostock",32,10,42,0,33
2011-08-22 01:36:24.000,"Mike Bostock","Mike Bostock",49,1,50,0,34
2011-08-22 01:28:32.000,"Mike Bostock","Mike Bostock",57,1,58,0,31
2011-08-22 01:16:57.000,"Mike Bostock","Mike Bostock",154,10,164,0,39
2011-08-21 23:54:17.000,"Mike Bostock","Mike Bostock",61,13,74,0,231
2011-08-21 23:21:57.000,"Mike Bostock","Mike Bostock",35,2,37,0,29
2011-08-21 23:19:09.000,"Mike Bostock","Mike Bostock",31,1,32,0,29
2011-08-21 23:01:31.000,"Mike Bostock","Mike Bostock",101,2,103,0,44
2011-08-21 07:50:34.000,"Mike Bostock","Mike Bostock",248,39,287,0,481
2011-08-21 01:04:50.000,"Mike Bostock","Mike Bostock",8,14,22,0,28
2011-08-21 01:04:04.000,"Mike Bostock","Mike Bostock",32,32,64,0,62
2011-08-21 00:27:25.000,"Mike Bostock","Mike Bostock",1540,1652,3192,0,1607
2011-08-20 14:38:46.000,"Jason Davies","Jason Davies",2,2,4,0,22
2011-08-19 23:22:46.000,"Mike Bostock","Mike Bostock",259,61,320,0,91
2011-08-19 22:45:56.000,"Mike Bostock","Mike Bostock",18,5,23,0,30
2011-08-19 22:44:23.000,"Mike Bostock","Mike Bostock",82,4,86,0,43
2011-08-19 22:26:39.000,"Mike Bostock","Mike Bostock",254,1,255,0,245
2011-08-19 22:02:47.000,"Mike Bostock","Mike Bostock",2516,0,2516,0,17
2011-08-19 21:57:06.000,"Mike Bostock","Mike Bostock",12,8,20,0,37
2011-08-19 21:56:02.000,"Mike Bostock","Mike Bostock",33,16,49,0,38
2011-08-19 21:55:43.000,"Mike Bostock","Mike Bostock",15082,44983,60065,0,39
2011-08-19 19:02:39.000,"Mike Bostock","Mike Bostock",33,16,49,0,22
2011-08-19 19:01:12.000,"Mike Bostock","Mike Bostock",26,5,31,0,63
2011-08-19 18:57:46.000,"Mike Bostock","Mike Bostock",3,3,6,0,47
2011-08-19 18:56:37.000,"Mike Bostock","Mike Bostock",4,6,10,0,11
2011-08-19 18:55:48.000,"Mike Bostock","Mike Bostock",7,9,16,0,70
2011-08-19 18:10:29.000,"Mike Bostock","Mike Bostock",3,3,6,0,40
2011-08-19 11:13:22.000,"Jason Davies","Jason Davies",7,9,16,0,125
2011-08-18 22:59:55.000,"Mike Bostock","Mike Bostock",1099,661,1760,0,38
2011-08-18 20:44:31.000,"Mike Bostock","Mike Bostock",9308,46627,55935,0,38
2011-08-18 18:14:34.000,"Mike Bostock","Mike Bostock",169,0,169,0,19
2011-08-18 17:54:50.000,"Mike Bostock","Mike Bostock",42,8,50,0,178
2011-08-18 00:24:19.000,"Mike Bostock","Mike Bostock",1499,3457,4956,0,19
2011-08-18 00:22:20.000,"Mike Bostock","Mike Bostock",3,3,6,5,37
2011-08-18 00:13:50.000,"Mike Bostock","Mike Bostock",8,4,12,0,45
2011-08-18 00:07:28.000,"Mike Bostock","Mike Bostock",222,11,233,0,95
2011-08-17 22:58:49.000,"Mike Bostock","Mike Bostock",214,78,292,0,46
2011-08-17 22:24:54.000,"Mike Bostock","Mike Bostock",90,0,90,0,29
2011-08-17 22:09:34.000,"Mike Bostock","Mike Bostock",164,65,229,0,26
2011-08-17 21:27:55.000,"Mike Bostock","Mike Bostock",135,16,151,0,87
2011-08-17 21:13:37.000,"Mike Bostock","Mike Bostock",4,3204,3208,0,112
2011-08-17 07:11:52.000,"Mike Bostock","Mike Bostock",75,0,75,0,32
2011-08-17 06:51:32.000,"Mike Bostock","Mike Bostock",74,5,79,0,28
2011-08-17 06:39:02.000,"Mike Bostock","Mike Bostock",40,1,41,0,24
2011-08-17 06:30:46.000,"Mike Bostock","Mike Bostock",38,0,38,0,17
2011-08-17 06:28:15.000,"Mike Bostock","Mike Bostock",378,72,450,0,30
2011-08-17 05:21:16.000,"Mike Bostock","Mike Bostock",74,18,92,0,165
2011-08-16 20:31:00.000,"Mike Bostock","Mike Bostock",462,11,473,0,19
2011-08-16 20:26:47.000,"Mike Bostock","Mike Bostock",133,4,137,0,18
2011-08-16 19:32:32.000,"Mike Bostock","Mike Bostock",116,0,116,0,22
2011-08-16 19:16:53.000,"Mike Bostock","Mike Bostock",109,6,115,0,137
2011-08-16 18:59:34.000,"Mike Bostock","Mike Bostock",50,0,50,0,22
2011-08-16 18:51:55.000,"Mike Bostock","Mike Bostock",56,3,59,0,67
2011-08-16 06:22:18.000,"Mike Bostock","Mike Bostock",240,8,248,0,19
2011-08-16 06:19:58.000,"Mike Bostock","Mike Bostock",38,0,38,0,20
2011-08-16 05:47:14.000,"Mike Bostock","Mike Bostock",29,0,29,0,21
2011-08-16 05:41:03.000,"Mike Bostock","Mike Bostock",34,0,34,0,19
2011-08-16 05:29:55.000,"Mike Bostock","Mike Bostock",27,0,27,0,19
2011-08-16 05:23:34.000,"Mike Bostock","Mike Bostock",110,6,116,0,105
2011-08-16 00:45:54.000,"Mike Bostock","Mike Bostock",7136,43383,50519,0,22
2011-08-16 00:43:59.000,"Mike Bostock","Mike Bostock",39,0,39,0,30
2011-08-16 00:39:11.000,"Mike Bostock","Mike Bostock",3,3,6,0,95
2011-08-16 00:28:48.000,"Mike Bostock","Mike Bostock",2,37114,37116,0,48
2011-08-16 00:25:39.000,"Mike Bostock","Mike Bostock",64,247,311,0,28
2011-08-16 00:02:41.000,"Mike Bostock","Mike Bostock",166,89,255,0,24
2011-08-15 23:53:46.000,"Mike Bostock","Mike Bostock",176,146,322,0,23
2011-08-15 23:42:01.000,"Mike Bostock","Mike Bostock",76,140,216,0,27
2011-08-15 23:30:26.000,"Mike Bostock","Mike Bostock",13,66,79,0,34
2011-08-15 23:22:39.000,"Mike Bostock","Mike Bostock",139,188,327,0,23
2011-08-15 23:12:54.000,"Mike Bostock","Mike Bostock",141,210,351,0,102
2011-08-15 22:12:17.000,"Mike Bostock","Mike Bostock",155,128,283,0,89
2011-08-15 21:32:34.000,"Mike Bostock","Mike Bostock",91,41,132,0,30
2011-08-15 21:07:28.000,"Mike Bostock","Mike Bostock",96,106,202,0,24
2011-08-15 20:55:42.000,"Mike Bostock","Mike Bostock",83,143,226,0,22
2011-08-15 20:50:20.000,"Mike Bostock","Mike Bostock",95,188,283,0,22
2011-08-15 20:16:14.000,"Mike Bostock","Mike Bostock",67,18,85,0,21
2011-08-15 19:40:42.000,"Mike Bostock","Mike Bostock",471,1340,1811,0,44
2011-08-15 05:50:20.000,"Mike Bostock","Mike Bostock",156,303,459,0,32
2011-08-15 05:30:17.000,"Mike Bostock","Mike Bostock",122,72,194,0,29
2011-08-15 05:28:10.000,"Mike Bostock","Mike Bostock",119,72,191,0,25
2011-08-15 05:03:01.000,"Mike Bostock","Mike Bostock",35,12,47,0,29
2011-08-15 04:55:11.000,"Mike Bostock","Mike Bostock",73,72,145,0,24
2011-08-15 04:54:48.000,"Mike Bostock","Mike Bostock",41,36,77,0,23
2011-08-15 04:47:20.000,"Mike Bostock","Mike Bostock",105,85,190,0,24
2011-08-15 04:38:02.000,"Mike Bostock","Mike Bostock",59,36,95,0,23
2011-08-15 04:29:08.000,"Mike Bostock","Mike Bostock",101,70,171,0,26
2011-08-15 04:23:23.000,"Mike Bostock","Mike Bostock",41,36,77,0,25
2011-08-15 04:18:58.000,"Mike Bostock","Mike Bostock",64,0,64,0,38
2011-08-15 04:02:49.000,"Mike Bostock","Mike Bostock",89,68,157,0,25
2011-08-15 03:51:53.000,"Mike Bostock","Mike Bostock",53,36,89,0,24
2011-08-15 03:38:02.000,"Mike Bostock","Mike Bostock",87,64,151,0,26
2011-08-15 03:22:27.000,"Mike Bostock","Mike Bostock",35,1,36,0,34
2011-08-15 03:16:56.000,"Mike Bostock","Mike Bostock",43,32,75,0,25
2011-08-15 02:59:01.000,"Mike Bostock","Mike Bostock",85,80,165,0,24
2011-08-15 02:14:59.000,"Mike Bostock","Mike Bostock",103,113,216,0,23
2011-08-15 01:20:28.000,"Mike Bostock","Mike Bostock",67,38,105,0,22
2011-08-15 01:01:15.000,"Mike Bostock","Mike Bostock",89,65,154,0,23
2011-08-14 22:37:24.000,"Mike Bostock","Mike Bostock",104,30,134,0,51
2011-08-14 21:07:20.000,"Mike Bostock","Mike Bostock",44,24,68,0,24
2011-08-14 20:57:09.000,"Mike Bostock","Mike Bostock",236,376,612,0,18
2011-08-14 19:52:59.000,"Mike Bostock","Mike Bostock",203,150,353,0,25
2011-08-14 19:16:03.000,"Mike Bostock","Mike Bostock",90,96,186,0,17
2011-08-14 18:44:58.000,"Mike Bostock","Mike Bostock",101,93,194,0,17
2011-08-14 18:11:37.000,"Mike Bostock","Mike Bostock",200,366,566,0,20
2011-08-14 17:29:42.000,"Mike Bostock","Mike Bostock",70,141,211,0,19
2011-08-14 17:11:33.000,"Mike Bostock","Mike Bostock",53,65,118,0,21
2011-08-14 17:03:00.000,"Mike Bostock","Mike Bostock",43,0,43,0,21
2011-08-14 07:13:10.000,"Mike Bostock","Mike Bostock",38,3,41,0,23
2011-08-14 07:09:37.000,"Mike Bostock","Mike Bostock",31,23,54,0,18
2011-08-14 07:00:24.000,"Mike Bostock","Mike Bostock",47,56,103,0,20
2011-08-14 06:54:08.000,"Mike Bostock","Mike Bostock",32,39,71,0,17
2011-08-14 06:45:02.000,"Mike Bostock","Mike Bostock",100,148,248,0,26
2011-08-14 03:25:54.000,"Mike Bostock","Mike Bostock",2,2,4,0,15
2011-08-14 03:10:38.000,"Mike Bostock","Mike Bostock",87,0,87,0,26
2011-08-14 02:47:23.000,"Mike Bostock","Mike Bostock",0,62,62,0,39
2011-08-14 02:46:20.000,"Mike Bostock","Mike Bostock",39,0,39,0,30
2011-08-14 02:40:38.000,"Mike Bostock","Mike Bostock",79,2,81,0,38
2011-08-14 02:22:13.000,"Mike Bostock","Mike Bostock",122,0,122,0,30
2011-08-14 02:15:14.000,"Mike Bostock","Mike Bostock",28,1,29,0,26
2011-08-14 02:08:34.000,"Mike Bostock","Mike Bostock",9,0,9,0,41
2011-08-14 02:05:02.000,"Mike Bostock","Mike Bostock",162,2,164,0,28
2011-08-14 02:04:34.000,"Mike Bostock","Mike Bostock",18,0,18,0,24
2011-08-14 01:33:45.000,"Mike Bostock","Mike Bostock",74,0,74,0,45
2011-08-14 01:27:54.000,"Mike Bostock","Mike Bostock",70,0,70,0,28
2011-08-14 00:45:10.000,"Mike Bostock","Mike Bostock",115,0,115,0,28
2011-08-13 22:43:04.000,"Mike Bostock","Mike Bostock",103,0,103,0,28
2011-08-13 22:23:02.000,"Mike Bostock","Mike Bostock",77,0,77,0,28
2011-08-13 19:36:39.000,"Mike Bostock","Mike Bostock",50,0,50,0,28
2011-08-13 19:34:41.000,"Mike Bostock","Mike Bostock",51,0,51,0,29
2011-08-13 19:28:40.000,"Mike Bostock","Mike Bostock",47,0,47,0,27
2011-08-13 19:13:38.000,"Mike Bostock","Mike Bostock",65,0,65,0,34
2011-08-13 19:00:52.000,"Mike Bostock","Mike Bostock",53,0,53,0,26
2011-08-13 18:48:01.000,"Mike Bostock","Mike Bostock",187,63,250,0,31
2011-08-13 18:26:24.000,"Mike Bostock","Mike Bostock",65,31,96,0,28
2011-08-13 18:19:14.000,"Mike Bostock","Mike Bostock",0,119,119,0,28
2011-08-13 18:18:49.000,"Mike Bostock","Mike Bostock",0,61,61,0,37
2011-08-13 18:18:40.000,"Mike Bostock","Mike Bostock",103,0,103,0,28
2011-08-13 07:58:56.000,"Mike Bostock","Mike Bostock",98,0,98,0,47
2011-08-13 07:26:46.000,"Mike Bostock","Mike Bostock",219,24,243,0,45
2011-08-13 05:52:45.000,"Mike Bostock","Mike Bostock",54,96,150,0,38
2011-08-13 05:52:10.000,"Mike Bostock","Mike Bostock",207,0,207,0,46
2011-08-13 05:50:50.000,"Mike Bostock","Mike Bostock",63,0,63,0,30
2011-08-13 05:42:40.000,"Mike Bostock","Mike Bostock",53,0,53,0,19
2011-08-13 02:07:42.000,"Mike Bostock","Mike Bostock",148,0,148,0,41
2011-08-06 17:09:27.000,"Mike Bostock","Mike Bostock",207,143,350,0,329
2011-08-11 09:22:40.000,"Mitsutoshi Aoe","Mitsutoshi Aoe",0,0,0,0,117
2011-08-08 03:51:41.000,"Mitsutoshi Aoe","Mitsutoshi Aoe",3,2,5,0,21
2011-08-08 03:50:47.000,"Mitsutoshi Aoe","Mitsutoshi Aoe",2,1,3,0,36
2011-08-10 02:52:52.000,"Mike Bostock + Erica Kwan","Mike Bostock + Erica Kwan",3,2,5,0,43
2011-08-09 20:29:17.000,"Mike Bostock","Mike Bostock",8,9,17,0,17
2011-08-09 19:25:00.000,"Mike Bostock","Mike Bostock",70,0,70,0,33
2011-08-09 19:24:48.000,"Mike Bostock","Mike Bostock",123,0,123,0,36
2011-08-08 03:51:41.000,"Mitsutoshi Aoe","Mitsutoshi Aoe",3,2,5,0,21
2011-08-08 03:50:47.000,"Mitsutoshi Aoe","Mitsutoshi Aoe",2,1,3,0,36
2011-08-01 22:38:46.000,"Mike Bostock","Mike Bostock",738,0,738,0,23
2011-08-01 19:25:42.000,"Mike Bostock","Mike Bostock",221,73,294,0,22
2011-08-01 19:23:26.000,"Mike Bostock","Mike Bostock",15,29,44,0,45
2011-08-01 19:16:38.000,"Mike Bostock","Mike Bostock",206,44,250,0,42
2011-08-01 01:31:24.000,"Mike Bostock","Mike Bostock",457,114,571,0,19
2011-08-01 01:28:04.000,"Mike Bostock","Mike Bostock",454,111,565,0,412
2011-08-01 01:11:34.000,"Mike Bostock","Mike Bostock",23,5,28,0,29
2011-08-01 00:14:21.000,"Mike Bostock","Mike Bostock",0,1,1,0,15
2011-08-01 00:11:35.000,"Mike Bostock","Mike Bostock",24,9,33,0,22
2011-08-01 00:09:13.000,"Mike Bostock","Mike Bostock",21,8,29,0,43
2011-07-27 18:03:40.000,"Jason Davies","Jason Davies",5,3,8,0,207
2011-07-21 00:15:57.000,"Mike Bostock","Mike Bostock",2896,166,3062,0,22
2011-07-20 23:24:27.000,"Mike Bostock","Mike Bostock",2582,140,2722,0,32
2011-07-20 23:21:09.000,"Mike Bostock","Mike Bostock",45,3,48,0,94
2011-07-20 23:11:07.000,"Mike Bostock","Mike Bostock",124,123,247,0,42
2011-07-20 21:56:44.000,"Mike Bostock","Mike Bostock",848,75,923,0,161
2011-07-20 20:50:06.000,"Mike Bostock","Mike Bostock",32,32,64,0,29
2011-07-20 09:07:14.000,"Jason Davies","Jason Davies",56,0,56,0,30
2011-07-20 08:07:44.000,"Jason Davies","Jason Davies",18,3,21,0,31
2011-07-20 01:08:40.000,"Mike Bostock","Mike Bostock",866,3,869,0,18
2011-07-19 23:47:00.000,"Jason Davies","Jason Davies",10,10,20,0,50
2011-07-19 23:45:15.000,"Jason Davies","Jason Davies",7,23,30,0,83
2011-07-19 23:07:05.000,"Jason Davies","Jason Davies",78,3,81,0,45
2011-07-19 22:45:57.000,"Jason Davies","Jason Davies",107,43,150,0,45
2011-07-19 21:58:44.000,"Jason Davies","Jason Davies",7,7,14,0,45
2011-07-19 21:02:01.000,"Jason Davies","Jason Davies",86,35,121,0,172
2011-07-19 02:08:06.000,"Mike Bostock","Mike Bostock",185,185,370,0,28
2011-07-19 01:56:30.000,"Mike Bostock","Mike Bostock",808,2,810,0,37
2011-07-17 04:45:11.000,"Mike Bostock","Mike Bostock",44,24,68,0,22
2011-07-17 04:42:49.000,"Mike Bostock","Mike Bostock",3,3,6,0,20
2011-07-17 04:42:18.000,"Mike Bostock","Mike Bostock",1,1,2,0,65
2011-07-17 04:41:26.000,"Mike Bostock","Mike Bostock",5,5,10,0,72
2011-07-17 04:40:57.000,"Mike Bostock","Mike Bostock",4,4,8,0,74
2011-07-17 04:40:29.000,"Mike Bostock","Mike Bostock",17,5,22,0,81
2011-07-17 04:39:09.000,"Mike Bostock","Mike Bostock",13,7,20,0,72
2011-07-17 04:37:08.000,"Mike Bostock","Mike Bostock",2,1,3,0,23
2011-07-16 18:16:41.000,"Jason Davies","Jason Davies",5,5,10,0,9
2011-07-16 00:49:25.000,"Jason Davies","Jason Davies",4,4,8,0,19
2011-07-15 00:39:34.000,"Tommy Montgomery","Tommy Montgomery",1,1,2,0,76
2011-07-14 10:02:43.000,"Jason Davies","Jason Davies",17,5,22,0,391
2011-07-12 18:29:55.000,"Jason Davies","Jason Davies",11,9,20,0,183
2011-07-12 17:32:20.000,"Jason Davies","Jason Davies",7,15,22,0,207
2011-07-12 16:48:27.000,"Jason Davies","Jason Davies",3,3,6,0,40
2011-07-12 16:42:12.000,"Jason Davies","Jason Davies",13,3,16,0,41
2011-07-12 04:53:57.000,"Caged","Caged",1,0,1,0,63
2011-07-10 18:28:38.000,"Mike Bostock","Mike Bostock",304,290,594,0,168
2011-07-10 05:00:51.000,"Mike Bostock","Mike Bostock",718,329,1047,0,22
2011-07-10 04:30:14.000,"Mike Bostock","Mike Bostock",263,173,436,1,259
2011-07-10 00:03:07.000,"Mike Bostock","Mike Bostock",11,13,24,0,32
2011-07-09 23:55:44.000,"Mike Bostock","Mike Bostock",130,85,215,0,535
2011-07-09 23:15:14.000,"Mike Bostock","Mike Bostock",37,30,67,0,16
2011-07-09 22:45:19.000,"Mike Bostock","Mike Bostock",277,28,305,0,31
2011-07-09 06:44:41.000,"Mike Bostock","Mike Bostock",407,41,448,0,22
2011-07-09 06:43:05.000,"Mike Bostock","Mike Bostock",389,23,412,0,42
2011-07-09 06:42:26.000,"Mike Bostock","Mike Bostock",15,15,30,0,24
2011-07-09 06:39:34.000,"Mike Bostock","Mike Bostock",104,0,104,0,31
2011-07-09 06:39:08.000,"Mike Bostock","Mike Bostock",15,9,24,0,37
2011-07-09 00:24:17.000,"Jason Davies","Jason Davies",14,36,50,0,94
2011-07-08 23:23:50.000,"Jason Davies","Jason Davies",77,23,100,0,321
2011-07-08 22:55:23.000,"Jason Davies","Jason Davies",7,1,8,0,45
2011-07-08 22:41:01.000,"Jason Davies","Jason Davies",84,0,84,0,93
2011-07-08 22:19:28.000,"Jason Davies","Jason Davies",7,3,10,0,35
2011-07-08 22:11:49.000,"Jason Davies","Jason Davies",31,35,66,0,46
2011-07-08 21:55:31.000,"Jason Davies","Jason Davies",88,0,88,0,193
2011-07-08 21:23:41.000,"Jason Davies","Jason Davies",15,3,18,0,115
2011-07-08 21:20:38.000,"Jason Davies","Jason Davies",39,17,56,0,181
2011-07-08 21:11:34.000,"Jason Davies","Jason Davies",3,3,6,0,79
2011-07-08 20:57:17.000,"Jason Davies","Jason Davies",19,7,26,0,55
2011-07-07 16:47:36.000,"Ignacio","Ignacio",7,7,14,0,41
2011-07-06 23:19:45.000,"Jason Davies","Jason Davies",0,1,1,0,38
2011-07-06 20:29:17.000,"Jason Davies","Jason Davies",2,4,6,0,36
2011-07-06 19:54:58.000,"Jason Davies","Jason Davies",5209,1055,6264,0,87
2011-07-06 19:52:32.000,"Jason Davies","Jason Davies",0,5,5,0,47
2011-07-06 18:57:14.000,"Jason Davies","Jason Davies",75,326,401,4,48
2011-07-04 17:43:37.000,"Mike Bostock","Mike Bostock",3,6,9,0,16
2011-07-04 17:41:32.000,"Mike Bostock","Mike Bostock",3,3,6,0,43
2011-07-04 17:38:25.000,"Mike Bostock","Mike Bostock",3,3,6,0,76
2011-07-04 08:05:56.000,"Jan Alonzo","Jan Alonzo",3,3,6,0,151
2011-07-03 15:59:09.000,"Mike Bostock","Mike Bostock",11,7,18,0,16
2011-07-03 15:46:07.000,"Mike Bostock","Mike Bostock",135,3,138,0,25
2011-07-03 01:16:57.000,"Mike Bostock","Mike Bostock",650,434,1084,0,24
2011-07-03 01:14:34.000,"Mike Bostock","Mike Bostock",46,24,70,0,258
2011-07-03 00:38:00.000,"Mike Bostock","Mike Bostock",139,0,139,0,20
2011-07-03 00:36:59.000,"Mike Bostock","Mike Bostock",6,5,11,0,28
2011-07-03 00:31:12.000,"Mike Bostock","Mike Bostock",431,388,819,0,279
2011-07-02 23:59:19.000,"Mike Bostock","Mike Bostock",18,49,67,0,48
2011-07-02 23:49:50.000,"Mike Bostock","Mike Bostock",86,62,148,0,183
2011-07-02 22:49:31.000,"Mike Bostock","Mike Bostock",25,7,32,0,232
2011-07-02 16:49:05.000,"Mike Bostock","Mike Bostock",5,5,10,0,30
2011-07-02 16:48:16.000,"Mike Bostock","Mike Bostock",2,2,4,0,76
2011-06-30 02:50:42.000,"Mike Bostock","Mike Bostock",58,4,62,0,146
2011-06-28 21:27:03.000,"Mike Bostock","Mike Bostock",167,133,300,0,263
2011-06-28 00:06:59.000,"vtstarin","vtstarin",2,2,4,0,38
2011-06-26 01:31:02.000,"Nathan Vander Wilt","Nathan Vander Wilt",1,1,2,0,16
2011-06-25 21:26:32.000,"Mike Bostock","Mike Bostock",1,2,3,0,21
2011-06-25 18:48:31.000,"Mike Bostock","Mike Bostock",13,19,32,0,46
2011-06-25 18:41:38.000,"Mike Bostock","Mike Bostock",110,0,110,0,35
2011-06-24 04:52:17.000,"Mike Bostock","Mike Bostock",1091,164,1255,0,22
2011-06-24 04:50:36.000,"Mike Bostock","Mike Bostock",895,64,959,0,32
2011-06-24 04:49:33.000,"Mike Bostock","Mike Bostock",107,66,173,0,23
2011-06-24 04:17:06.000,"Mike Bostock","Mike Bostock",720,13,733,0,31
2011-06-24 04:03:27.000,"Mike Bostock","Mike Bostock",99,39,138,0,76
2011-06-24 03:53:28.000,"Mike Bostock","Mike Bostock",41,10,51,0,57
2011-06-12 07:10:42.000,"Mike Bostock","Mike Bostock",4,12,16,0,34
2011-06-24 03:45:23.000,"Mike Bostock","Mike Bostock",139,119,258,0,459
2011-06-23 19:28:55.000,"Mike Bostock","Mike Bostock",56,70,126,0,364
2011-06-23 18:40:39.000,"Mike Bostock","Mike Bostock",7,7,14,0,28
2011-06-23 01:09:31.000,"Mike Bostock","Mike Bostock",57,72,129,0,44
2011-06-23 00:49:01.000,"Mike Bostock","Mike Bostock",1,1,2,0,18
2011-06-23 00:42:14.000,"Mike Bostock","Mike Bostock",4,14,18,0,31
2011-06-22 22:33:34.000,"Mike Bostock","Mike Bostock",51,12,63,0,27
2011-06-22 21:17:18.000,"Mike Bostock","Mike Bostock",94,11,105,0,23
2011-06-22 20:01:23.000,"Jason Davies","Jason Davies",15,5,20,0,347
2011-06-22 19:45:40.000,"Jason Davies","Jason Davies",2,23,25,0,297
2011-06-22 18:56:58.000,"Jason Davies","Jason Davies",23,2,25,0,230
2011-06-22 18:25:57.000,"Mike Bostock","Mike Bostock",10,4,14,0,36
2011-06-22 17:46:52.000,"Mike Bostock","Mike Bostock",164,189,353,0,1037
2011-06-22 09:11:23.000,"Jason Davies","Jason Davies",168,33,201,0,94
2011-06-18 11:19:06.000,"Jason Davies","Jason Davies",28,0,28,0,30
2011-06-17 21:18:40.000,"Jason Davies","Jason Davies",66,18,84,0,60
2011-06-17 18:39:56.000,"Jason Davies","Jason Davies",2,11,13,0,16
2011-06-17 16:59:34.000,"Jason Davies","Jason Davies",508,1,509,0,125
2011-06-17 14:42:23.000,"Jason Davies","Jason Davies",41,10,51,0,131
2011-06-17 05:12:37.000,"Mike Bostock","Mike Bostock",502,51,553,0,22
2011-06-17 05:11:31.000,"Mike Bostock","Mike Bostock",9,2,11,0,36
2011-06-17 05:09:41.000,"Mike Bostock","Mike Bostock",122,36,158,0,31
2011-06-15 23:20:14.000,"Jason Davies","Jason Davies",9,2,11,0,261
2011-06-15 18:59:15.000,"Mike Bostock","Mike Bostock",28,0,28,0,33
2011-06-15 18:50:46.000,"Mike Bostock","Mike Bostock",73,64,137,0,37
2011-06-15 18:48:20.000,"Mike Bostock","Mike Bostock",145,0,145,0,39
2011-06-15 17:47:54.000,"Jason Davies","Jason Davies",34,34,68,0,34
2011-06-15 17:44:58.000,"Jason Davies","Jason Davies",88,2,90,0,24
2011-06-15 08:16:46.000,"Mike Bostock","Mike Bostock",187,11,198,0,27
2011-06-14 01:37:57.000,"Mike Bostock","Mike Bostock",29,29,58,0,22
2011-06-14 01:34:20.000,"Mike Bostock","Mike Bostock",5,5,10,0,46
2011-06-14 01:32:49.000,"Mike Bostock","Mike Bostock",13,13,26,0,259
2011-06-14 01:30:30.000,"Mike Bostock","Mike Bostock",8,8,16,0,17
2011-06-13 23:54:24.000,"Kevin J. Lynagh","Kevin J. Lynagh",1,1,2,0,106
2011-06-12 22:07:08.000,"Mike Bostock","Mike Bostock",322,0,322,0,19
2011-06-12 21:16:55.000,"Jason Davies","Jason Davies",237,476,713,0,189
2011-06-12 21:13:43.000,"Jason Davies","Jason Davies",14,27,41,0,45
2011-06-12 21:11:48.000,"Mike Bostock","Mike Bostock",68,0,68,0,29
2011-06-12 20:59:02.000,"Mike Bostock","Mike Bostock",14,27,41,0,28
2011-06-12 20:41:21.000,"Jason Davies","Jason Davies",43,43,86,0,30
2011-06-11 12:49:21.000,"Jason Davies","Jason Davies",574,0,574,0,77
2011-06-12 02:11:15.000,"Mike Bostock","Mike Bostock",10,10,20,0,29
2011-06-12 01:15:35.000,"Mike Bostock","Mike Bostock",4,3,7,0,12
2011-06-12 00:59:42.000,"Mike Bostock","Mike Bostock",119,0,119,0,26
2011-06-11 23:56:18.000,"Mike Bostock","Mike Bostock",12,8,20,0,490
2011-06-11 21:00:28.000,"Mike Bostock","Mike Bostock",4,3,7,0,34
2011-06-11 20:57:35.000,"Mike Bostock","Mike Bostock",281,24,305,0,27
2011-06-11 20:54:44.000,"Mike Bostock","Mike Bostock",105,193,298,0,278
2011-06-11 20:49:22.000,"Mike Bostock","Mike Bostock",398,103,501,0,39
2011-06-11 20:40:43.000,"Mike Bostock","Mike Bostock",398,103,501,0,22
2011-06-11 20:38:50.000,"Mike Bostock","Mike Bostock",1,1,2,0,27
2011-06-11 20:37:23.000,"Mike Bostock","Mike Bostock",60,18,78,0,41
2011-06-11 20:36:51.000,"Mike Bostock","Mike Bostock",36,0,36,0,45
2011-06-11 20:31:13.000,"Mike Bostock","Mike Bostock",24,18,42,0,328
2011-06-11 20:20:57.000,"Mike Bostock","Mike Bostock",158,2,160,0,32
2011-06-11 20:20:34.000,"Mike Bostock","Mike Bostock",12,12,24,0,45
2011-06-11 20:17:47.000,"Mike Bostock","Mike Bostock",69,98,167,0,172
2011-06-11 19:31:42.000,"Mike Bostock","Mike Bostock",170,73,243,0,221
2011-06-11 19:12:51.000,"Mike Bostock","Mike Bostock",12,12,24,0,242
2011-06-07 17:46:25.000,"Jason Davies","Jason Davies",35,57,92,0,130
2011-06-07 17:32:55.000,"Jason Davies","Jason Davies",8,8,16,0,15
2011-06-07 09:45:56.000,"Jason Davies","Jason Davies",23,15,38,0,39
2011-06-07 09:31:23.000,"Jason Davies","Jason Davies",55,3,58,0,277
2011-06-07 08:44:02.000,"Jason Davies","Jason Davies",25,10,35,0,37
2011-06-07 06:51:16.000,"Mike Bostock","Mike Bostock",33,15,48,0,68
2011-06-07 06:50:10.000,"Mike Bostock","Mike Bostock",5,3,8,0,10
2011-06-07 06:38:08.000,"Mike Bostock","Mike Bostock",328,109,437,0,24
2011-06-07 05:59:18.000,"chris viau","chris viau",35,16,51,0,17
2011-06-07 03:55:18.000,"chris viau","chris viau",106,0,106,0,17
2011-06-07 00:38:41.000,"Jason Davies","Jason Davies",22,10,32,0,91
2011-06-07 00:29:45.000,"Jason Davies","Jason Davies",70,2,72,0,196
2011-06-06 23:51:05.000,"Jason Davies","Jason Davies",6,3,9,0,80
2011-06-06 23:40:04.000,"Jason Davies","Jason Davies",16,1,17,0,115
2011-06-06 23:34:16.000,"Jason Davies","Jason Davies",39,2,41,0,155
2011-06-06 18:48:00.000,"Jason Davies","Jason Davies",81,17,98,0,42
2011-06-06 17:54:22.000,"Jason Davies","Jason Davies",34,3,37,0,19
2011-06-06 08:57:35.000,"Jason Davies","Jason Davies",10,30,40,0,36
2011-06-03 07:25:28.000,"Mike Bostock","Mike Bostock",141,2,143,0,31
2011-06-02 20:17:41.000,"Mike Bostock","Mike Bostock",134,0,134,0,28
2011-05-30 21:39:32.000,"Mike Bostock","Mike Bostock",126,66,192,0,374
2011-05-30 17:31:19.000,"Mike Bostock","Mike Bostock",251,4,255,0,24
2011-05-30 17:29:34.000,"Mike Bostock","Mike Bostock",753,144,897,0,36
2011-05-30 17:26:23.000,"Mike Bostock","Mike Bostock",753,144,897,0,22
2011-05-30 17:23:45.000,"Mike Bostock","Mike Bostock",51,27,78,0,38
2011-05-30 17:23:39.000,"Mike Bostock","Mike Bostock",116,22,138,0,34
2011-05-30 17:22:28.000,"Mike Bostock","Mike Bostock",21,21,42,0,100
2011-05-30 17:09:39.000,"Mike Bostock","Mike Bostock",24,10,34,0,55
2011-05-30 10:09:53.000,"Jason Davies","Jason Davies",51,27,78,0,89
2011-05-30 09:43:47.000,"Jason Davies","Jason Davies",38,14,52,0,169
2011-05-30 09:38:17.000,"Jason Davies","Jason Davies",66,10,76,0,63
2011-05-29 06:57:18.000,"Mike Bostock","Mike Bostock",4579,836,5415,0,36
2011-05-28 08:13:53.000,"Mike Bostock","Mike Bostock",137,134,271,0,113
2011-05-28 06:26:29.000,"Mike Bostock","Mike Bostock",21,5,26,0,35
2011-05-27 23:48:54.000,"Mike Bostock","Mike Bostock",18,11,29,0,42
2011-05-27 22:58:06.000,"Mike Bostock","Mike Bostock",488,80,568,0,35
2011-05-27 22:54:56.000,"Mike Bostock","Mike Bostock",69,2,71,0,31
2011-05-27 22:54:15.000,"Mike Bostock","Mike Bostock",8,8,16,0,66
2011-05-27 22:46:59.000,"Mike Bostock","Mike Bostock",23,23,46,1,32
2011-05-27 20:34:08.000,"Jason Davies","Jason Davies",41,12,53,0,281
2011-05-27 09:36:36.000,"Jason Davies","Jason Davies",40,2,42,0,115
2011-05-27 05:15:28.000,"Mike Bostock","Mike Bostock",52,53,105,0,23
2011-05-26 08:10:14.000,"Mike Bostock","Mike Bostock",97,27,124,0,30
2011-05-23 21:09:04.000,"Jason Davies","Jason Davies",53,19,72,0,167
2011-05-19 22:31:34.000,"Jason Davies","Jason Davies",117,83,200,0,65
2011-05-23 09:45:34.000,"Jason Davies","Jason Davies",2564,557,3121,0,135
2011-05-22 19:26:46.000,"Mike Bostock","Mike Bostock",263,160,423,0,1363
2011-05-22 00:10:37.000,"Jason Davies","Jason Davies",8,8,16,0,103
2011-05-22 01:29:05.000,"Mike Bostock","Mike Bostock",1193,89,1282,0,22
2011-05-22 01:26:29.000,"Mike Bostock","Mike Bostock",428,58,486,0,34
2011-05-22 01:19:31.000,"Mike Bostock","Mike Bostock",13,15,28,0,444
2011-05-22 00:54:31.000,"Mike Bostock","Mike Bostock",40,36,76,0,36
2011-05-22 00:38:29.000,"Mike Bostock","Mike Bostock",141,55,196,0,478
2011-05-21 21:29:43.000,"Jason Davies","Jason Davies",21,5,26,0,50
2011-05-21 21:08:52.000,"Mike Bostock","Mike Bostock",7,7,14,0,17
2011-05-21 20:56:06.000,"Mike Bostock","Mike Bostock",596,150,746,0,287
2011-05-21 09:10:16.000,"Jason Davies","Jason Davies",278,59,337,0,104
2011-05-21 00:31:51.000,"Mike Bostock","Mike Bostock",1503,391,1894,0,36
2011-05-21 00:09:29.000,"Mike Bostock","Mike Bostock",7,25,32,0,67
2011-05-20 23:38:09.000,"Mike Bostock","Mike Bostock",134,56,190,0,330
2011-05-20 22:20:17.000,"Mike Bostock","Mike Bostock",155,2,157,0,13
2011-05-20 20:04:35.000,"Jason Davies","Jason Davies",27,0,27,0,41
2011-05-20 14:44:07.000,"Jason Davies","Jason Davies",16,0,16,0,18
2011-05-19 21:04:51.000,"Jason Davies","Jason Davies",28,21,49,0,84
2011-05-19 20:43:12.000,"Jason Davies","Jason Davies",132,14,146,0,278
2011-05-14 20:38:20.000,"Jeffrey Heer","Jeffrey Heer",12,2,14,0,33
2011-05-14 18:58:30.000,"Jason Davies","Jason Davies",25,3,28,0,8
2011-05-13 19:17:00.000,"Jason Davies","Jason Davies",167,27,194,0,201
2011-05-13 14:28:44.000,"Jason Davies","Jason Davies",29,13,42,0,44
2011-05-12 19:56:15.000,"Mike Bostock","Mike Bostock",418,129,547,0,22
2011-05-12 19:54:38.000,"Mike Bostock","Mike Bostock",99,30,129,0,104
2011-05-12 19:28:31.000,"Mike Bostock","Mike Bostock",3,5,8,0,31
2011-05-12 19:26:09.000,"Mike Bostock","Mike Bostock",49,26,75,0,33
2011-05-12 18:45:24.000,"Mike Bostock","Mike Bostock",229,111,340,1,733
2011-05-12 18:25:05.000,"Mike Bostock","Mike Bostock",83,2,85,0,15
2011-05-12 17:20:07.000,"Jason Davies","Jason Davies",10,20,30,0,199
2011-05-12 10:10:04.000,"Jason Davies","Jason Davies",20,10,30,0,111
2011-05-11 17:26:48.000,"Jason Davies","Jason Davies",49,32,81,0,42
2011-05-11 16:52:37.000,"Jason Davies","Jason Davies",4,4,8,0,160
2011-05-11 16:42:24.000,"Jason Davies","Jason Davies",15,5,20,0,64
2011-05-11 10:03:39.000,"Jason Davies","Jason Davies",24,1,25,0,18
2011-05-11 08:35:12.000,"Jason Davies","Jason Davies",50,13,63,0,31
2011-05-11 08:14:31.000,"Jason Davies","Jason Davies",3,3,6,0,45
2011-05-10 22:42:16.000,"Jason Davies","Jason Davies",9,3,12,0,362
2011-05-10 19:18:14.000,"Jason Davies","Jason Davies",3,3,6,0,31
2011-05-10 19:06:24.000,"Jason Davies","Jason Davies",136,28,164,3,428
2011-05-10 04:32:27.000,"Mike Bostock","Mike Bostock",1397,103,1500,0,33
2011-05-09 23:58:54.000,"Jason Davies","Jason Davies",334,101,435,0,178
2011-05-09 09:05:44.000,"Jason Davies","Jason Davies",7,25,32,0,23
2011-05-09 03:54:40.000,"Mike Bostock","Mike Bostock",164,62,226,0,25
2011-05-09 03:52:12.000,"Mike Bostock","Mike Bostock",2,23,25,0,94
2011-05-08 07:24:42.000,"Mike Bostock","Mike Bostock",6,6,12,0,18
2011-05-08 07:20:02.000,"Mike Bostock","Mike Bostock",144,67,211,0,252
2011-05-08 00:51:30.000,"Mike Bostock","Mike Bostock",942,221,1163,0,22
2011-05-08 00:47:46.000,"Mike Bostock","Mike Bostock",31,1,32,0,33
2011-05-08 00:42:59.000,"Mike Bostock","Mike Bostock",162,160,322,0,31
2011-05-08 00:39:46.000,"Mike Bostock","Mike Bostock",37,7,44,0,49
2011-05-08 00:35:30.000,"Mike Bostock","Mike Bostock",8,6,14,0,42
2011-05-08 00:34:01.000,"Mike Bostock","Mike Bostock",276,7,283,0,36
2011-05-08 00:31:03.000,"Mike Bostock","Mike Bostock",130,84,214,0,261
2011-05-07 19:28:48.000,"Mike Bostock","Mike Bostock",102,14,116,0,36
2011-05-07 19:27:48.000,"Mike Bostock","Mike Bostock",64,0,64,0,22
2011-05-07 19:21:59.000,"Mike Bostock","Mike Bostock",32,34,66,0,301
2011-05-07 19:09:28.000,"Mike Bostock","Mike Bostock",311,35,346,0,33
2011-05-07 19:08:48.000,"Mike Bostock","Mike Bostock",106,12,118,0,18
2011-05-07 18:59:49.000,"Mike Bostock","Mike Bostock",114,92,206,0,44
2011-05-07 18:32:17.000,"Mike Bostock","Mike Bostock",20,14,34,0,74
2011-05-05 21:46:49.000,"Jason Davies","Jason Davies",2,2,4,0,25
2011-05-05 21:44:40.000,"Jason Davies","Jason Davies",58,12,70,0,71
2011-05-05 21:25:45.000,"Jason Davies","Jason Davies",1,1,2,0,23
2011-05-05 18:51:53.000,"Jason Davies","Jason Davies",8,6,14,0,182
2011-05-05 17:27:43.000,"Jason Davies","Jason Davies",46,16,62,0,244
2011-05-05 16:25:49.000,"Jason Davies","Jason Davies",30,24,54,0,49
2011-05-05 16:20:54.000,"Jason Davies","Jason Davies",8,14,22,0,120
2011-05-05 14:32:26.000,"Jason Davies","Jason Davies",95,49,144,0,142
2011-05-05 13:27:33.000,"Jason Davies","Jason Davies",14,8,22,0,48
2011-05-05 13:23:04.000,"Jason Davies","Jason Davies",8,2,10,0,157
2011-05-05 12:32:14.000,"Jason Davies","Jason Davies",88,4,92,0,53
2011-05-04 00:23:09.000,"Mike Bostock","Mike Bostock",31,1,32,0,26
2011-05-03 17:27:02.000,"Jason Davies","Jason Davies",4,4,8,0,113
2011-05-03 17:17:03.000,"Jason Davies","Jason Davies",26,12,38,0,44
2011-05-03 13:38:56.000,"Jason Davies","Jason Davies",24,6,30,0,291
2011-05-03 12:20:48.000,"Jason Davies","Jason Davies",3,3,6,0,313
2011-05-03 11:26:43.000,"Jason Davies","Jason Davies",3,5,8,0,26
2011-05-03 02:51:36.000,"Mike Bostock","Mike Bostock",217,1,218,0,67
2011-05-03 02:46:08.000,"Mike Bostock","Mike Bostock",158,5,163,0,62
2011-05-03 02:42:39.000,"Mike Bostock","Mike Bostock",23,4,27,0,32
2011-05-03 01:11:44.000,"Mike Bostock","Mike Bostock",57,4,61,0,29
2011-05-01 16:08:24.000,"Jason Davies","Jason Davies",158,5,163,0,86
2011-05-02 00:15:09.000,"Jason Davies","Jason Davies",20,0,20,0,44
2011-05-01 09:48:01.000,"Jason Davies","Jason Davies",217,1,218,0,21
2011-05-01 23:31:25.000,"Jason Davies","Jason Davies",82,80,162,0,17
2011-05-01 23:31:01.000,"Jason Davies","Jason Davies",2,2,4,3,44
2011-05-01 20:31:34.000,"Mike Bostock","Mike Bostock",8,4,12,0,27
2011-05-01 18:24:38.000,"Mike Bostock","Mike Bostock",3,4,7,0,26
2011-05-01 18:22:45.000,"Mike Bostock","Mike Bostock",1,2,3,0,23
2011-05-01 17:58:46.000,"Mike Bostock","Mike Bostock",10,8,18,0,258
2011-05-01 05:53:01.000,"Mike Bostock","Mike Bostock",1255,203,1458,0,60
2011-05-01 05:52:14.000,"Mike Bostock","Mike Bostock",43,35,78,2,30
2011-05-01 05:18:52.000,"Mike Bostock","Mike Bostock",652,4,656,0,127
2011-05-01 05:16:58.000,"Mike Bostock","Mike Bostock",291,356,647,0,25
2011-05-01 00:50:45.000,"Mike Bostock","Mike Bostock",242,93,335,0,250
2011-05-01 00:47:38.000,"Mike Bostock","Mike Bostock",96,88,184,1,37
2011-04-30 23:58:56.000,"Mike Bostock","Mike Bostock",128,0,128,0,161
2011-04-30 23:56:03.000,"Mike Bostock","Mike Bostock",77,78,155,0,330
2011-04-30 21:19:28.000,"Mike Bostock","Mike Bostock",19,1,20,0,22
2011-04-30 21:13:51.000,"Mike Bostock","Mike Bostock",69,69,138,0,23
2011-04-29 17:14:44.000,"Jason Davies","Jason Davies",109,0,109,0,24
2011-04-29 16:09:56.000,"Jason Davies","Jason Davies",27,8,35,0,95
2011-04-29 15:14:55.000,"Jason Davies","Jason Davies",110,0,110,0,219
2011-04-29 10:14:15.000,"Jason Davies","Jason Davies",4,9,13,0,314
2011-04-29 10:02:28.000,"Jason Davies","Jason Davies",30,37,67,0,136
2011-04-28 19:43:26.000,"Mike Bostock","Mike Bostock",22,12,34,0,38
2011-04-28 18:23:04.000,"Mike Bostock","Mike Bostock",74,88,162,0,323
2011-04-28 00:24:31.000,"Jason Davies","Jason Davies",35,11,46,0,562
2011-04-27 23:46:49.000,"Mike Bostock","Mike Bostock",25,21,46,0,44
2011-04-27 18:30:47.000,"Jason Davies","Jason Davies",45,41,86,0,232
2011-04-27 18:23:54.000,"Mike Bostock","Mike Bostock",21,7,28,0,45
2011-04-26 12:10:48.000,"Jason Davies","Jason Davies",242,93,335,0,26
2011-04-27 01:26:21.000,"Square","Square",148,46,194,0,20
2011-04-27 01:20:07.000,"Square","Square",29,39,68,0,42
2011-04-27 01:19:43.000,"Square","Square",3,3,6,0,28
2011-04-27 00:53:54.000,"Square","Square",85,13,98,0,246
2011-04-26 23:50:22.000,"Square","Square",2,0,2,0,35
2011-04-26 23:42:06.000,"Square","Square",41,21,62,0,324
2011-04-26 23:03:10.000,"Square","Square",10,8,18,0,43
2011-04-26 22:40:21.000,"Square","Square",17,1,18,0,45
2011-04-26 22:35:46.000,"Square","Square",9,9,18,0,180
2011-04-25 12:59:11.000,"Jason Davies","Jason Davies",188,3,191,0,32
2011-04-23 11:39:35.000,"Jason Davies","Jason Davies",137,135,272,0,213
2011-04-24 10:18:03.000,"Jason Davies","Jason Davies",529,1,530,0,13
2011-04-25 06:35:59.000,"Mike Bostock","Mike Bostock",3,3,6,0,25
2011-04-25 06:34:47.000,"Mike Bostock","Mike Bostock",21,27,48,0,24
2011-04-25 06:33:56.000,"Mike Bostock","Mike Bostock",592,252,844,0,20
2011-04-25 06:29:36.000,"Mike Bostock","Mike Bostock",4,4,8,0,75
2011-04-25 06:09:48.000,"Mike Bostock","Mike Bostock",8,8,16,0,34
2011-04-24 20:13:40.000,"Caged","Caged",4,4,8,0,75
2011-04-22 22:28:03.000,"Jason Davies","Jason Davies",9066,1463,10529,0,57
2011-04-20 05:01:38.000,"Mike Bostock","Mike Bostock",53,5,58,0,40
2011-04-20 04:24:19.000,"Mike Bostock","Mike Bostock",21,27,48,0,355
2011-04-20 03:18:35.000,"Mike Bostock","Mike Bostock",57,53,110,0,232
2011-04-20 02:02:19.000,"Mike Bostock","Mike Bostock",14,8,22,0,377
2011-04-20 01:50:09.000,"Mike Bostock","Mike Bostock",64,48,112,0,584
2011-04-19 21:56:50.000,"Mike Bostock","Mike Bostock",3,3,6,0,23
2011-04-19 21:47:19.000,"Mike Bostock","Mike Bostock",231,98,329,0,528
2011-04-19 21:03:41.000,"Mike Bostock","Mike Bostock",27,21,48,0,662
2011-04-19 20:39:37.000,"Mike Bostock","Mike Bostock",220,113,333,0,567
2011-04-19 20:17:46.000,"Mike Bostock","Mike Bostock",51,31,82,0,256
2011-04-15 00:51:53.000,"Mike Bostock","Mike Bostock",4,3,7,0,23
2011-04-14 23:23:53.000,"Jason Davies","Jason Davies",11,11,22,0,37
2011-04-14 22:20:07.000,"Mike Bostock","Mike Bostock",79,0,79,0,25
2011-04-14 09:41:19.000,"Jason Davies","Jason Davies",71,71,142,0,47
2011-04-14 07:59:15.000,"Mike Bostock","Mike Bostock",0,50,50,0,107
2011-04-14 07:58:46.000,"Mike Bostock","Mike Bostock",3,858,861,0,35
2011-04-14 07:54:47.000,"Mike Bostock","Mike Bostock",2511,117,2628,0,22
2011-04-14 07:53:59.000,"Mike Bostock","Mike Bostock",975,60,1035,0,31
2011-04-14 07:51:29.000,"Mike Bostock","Mike Bostock",703,53,756,0,35
2011-04-14 07:49:53.000,"Mike Bostock","Mike Bostock",758,1,759,0,32
2011-04-14 07:45:54.000,"Mike Bostock","Mike Bostock",0,1,1,0,18
2011-04-14 07:44:25.000,"Mike Bostock","Mike Bostock",17,17,34,0,32
2011-04-14 07:28:04.000,"Mike Bostock","Mike Bostock",7,7,14,0,262
2011-04-14 07:13:06.000,"Mike Bostock","Mike Bostock",106,71,177,0,496
2011-04-14 06:41:30.000,"Mike Bostock","Mike Bostock",35,69,104,0,217
2011-04-14 06:04:11.000,"Mike Bostock","Mike Bostock",157,207,364,0,499
2011-04-14 02:50:26.000,"Mike Bostock","Mike Bostock",47,37,84,0,443
2011-04-14 02:12:16.000,"Mike Bostock","Mike Bostock",115,0,115,0,25
2011-04-14 01:31:16.000,"Mike Bostock","Mike Bostock",249,121,370,4,1375
2011-04-14 01:16:51.000,"Mike Bostock","Mike Bostock",8,4,12,0,116
2011-04-13 23:40:00.000,"Jason Davies","Jason Davies",15,5,20,0,223
2011-04-13 23:27:52.000,"Jason Davies","Jason Davies",3,3,6,0,20
2011-04-13 23:27:25.000,"Jason Davies","Jason Davies",3,5,8,0,23
2011-04-13 23:20:16.000,"Jason Davies","Jason Davies",0,4,4,0,26
2011-04-13 23:16:10.000,"Jason Davies","Jason Davies",4,5,9,0,21
2011-04-13 23:12:18.000,"Jason Davies","Jason Davies",120,9,129,0,156
2011-04-13 22:33:15.000,"Jason Davies","Jason Davies",10,10,20,0,37
2011-04-13 22:31:53.000,"Jason Davies","Jason Davies",49,49,98,0,26
2011-04-13 22:29:44.000,"Jason Davies","Jason Davies",3,3,6,0,24
2011-04-13 22:27:25.000,"Jason Davies","Jason Davies",17,34,51,0,54
2011-04-13 22:21:29.000,"Jason Davies","Jason Davies",41,13,54,0,148
2011-04-13 21:59:37.000,"Jason Davies","Jason Davies",69,9,78,0,133
2011-04-13 21:09:31.000,"Jason Davies","Jason Davies",100,26,126,0,363
2011-04-13 20:39:12.000,"Jason Davies","Jason Davies",11,21,32,0,112
2011-04-13 20:35:33.000,"Jason Davies","Jason Davies",5,5,10,0,151
2011-04-13 20:34:13.000,"Jason Davies","Jason Davies",28,28,56,0,107
2011-04-13 20:13:58.000,"Jason Davies","Jason Davies",29,5,34,0,31
2011-04-13 18:53:52.000,"Jason Davies","Jason Davies",386,1,387,0,18
2011-04-12 03:11:44.000,"Nelson Minar","Nelson Minar",1,1,2,0,17
2011-04-12 03:10:27.000,"Nelson Minar","Nelson Minar",2,0,2,0,41
2011-04-12 03:09:19.000,"Nelson Minar","Nelson Minar",33,22,55,0,34
2011-04-12 03:02:48.000,"Nelson Minar","Nelson Minar",943,26,969,0,78
2011-04-11 21:52:21.000,"Mike Bostock","Mike Bostock",17,6,23,0,20
2011-04-11 21:22:24.000,"Mike Bostock","Mike Bostock",16,5,21,0,25
2011-04-11 20:55:27.000,"Mike Bostock","Mike Bostock",10,10,20,0,23
2011-04-11 20:44:17.000,"Mike Bostock","Mike Bostock",203,242,445,0,417
2011-04-11 11:25:19.000,"Jason Davies","Jason Davies",1,0,1,0,37
2011-04-11 10:50:34.000,"Jason Davies","Jason Davies",678,2,680,0,203
2011-04-11 09:54:33.000,"Jason Davies","Jason Davies",797,1,798,0,490
2011-04-11 07:26:35.000,"Mike Bostock","Mike Bostock",22,25,47,0,43
2011-04-11 02:56:16.000,"Mike Bostock","Mike Bostock",5,3,8,0,34
2011-04-11 02:44:45.000,"Mike Bostock","Mike Bostock",924,4,928,0,19
2011-04-11 02:37:23.000,"Mike Bostock","Mike Bostock",8,8,16,0,36
2011-04-11 02:28:59.000,"Mike Bostock","Mike Bostock",37,35,72,0,32
2011-04-11 00:16:13.000,"Nelson Minar","Nelson Minar",6,18,24,0,50
2011-04-10 22:42:25.000,"Nelson Minar","Nelson Minar",78,4,82,0,31
2011-04-10 21:56:34.000,"Mike Bostock","Mike Bostock",77,23,100,0,31
2011-04-10 21:29:32.000,"Mike Bostock","Mike Bostock",73,1,74,0,24
2011-04-10 21:15:15.000,"Mike Bostock","Mike Bostock",19,19,38,0,19
2011-04-10 21:04:21.000,"Mike Bostock","Mike Bostock",107,111,218,0,35
2011-04-10 20:47:32.000,"Mike Bostock","Mike Bostock",55,59,114,0,30
2011-04-10 20:36:58.000,"Mike Bostock","Mike Bostock",127,129,256,0,30
2011-04-10 20:16:26.000,"Mike Bostock","Mike Bostock",45,45,90,0,36
2011-04-10 20:07:17.000,"Mike Bostock","Mike Bostock",211,279,490,0,296
2011-04-10 18:45:51.000,"Mike Bostock","Mike Bostock",30,16,46,0,36
2011-04-10 16:25:04.000,"Jason Davies","Jason Davies",1,2,3,0,44
2011-04-10 10:46:13.000,"Jason Davies","Jason Davies",856,1,857,0,168
2011-04-09 22:14:10.000,"Mike Bostock","Mike Bostock",0,0,0,0,98
2011-04-09 22:09:09.000,"Jason Davies","Jason Davies",0,2,2,0,40
2011-04-09 21:46:25.000,"Mike Bostock","Mike Bostock",10,8,18,0,348
2011-04-09 21:00:38.000,"Mike Bostock","Mike Bostock",2,2,4,0,22
2011-04-09 20:38:48.000,"Mike Bostock","Mike Bostock",68,205,273,0,33
2011-04-09 20:08:14.000,"Mike Bostock","Mike Bostock",32,0,32,0,16
2011-04-09 20:05:55.000,"Mike Bostock","Mike Bostock",32,0,32,0,16
2011-04-09 20:03:52.000,"Mike Bostock","Mike Bostock",1,0,1,0,37
2011-04-09 19:27:30.000,"Mike Bostock","Mike Bostock",749,55,804,0,21
2011-04-09 19:23:53.000,"Mike Bostock","Mike Bostock",3,3,6,0,44
2011-04-09 18:55:33.000,"Mike Bostock","Mike Bostock",2,4,6,0,45
2011-04-09 18:43:09.000,"Mike Bostock","Mike Bostock",275,331,606,0,590
2011-04-09 18:35:04.000,"Mike Bostock","Mike Bostock",18,36,54,0,242
2011-04-09 16:41:26.000,"Jason Davies","Jason Davies",51,27,78,0,194
2011-04-09 00:42:43.000,"Michael Bostock","Michael Bostock",8,7,15,0,36
2011-04-09 00:37:01.000,"Michael Bostock","Michael Bostock",0,0,0,0,70
2011-04-09 00:36:16.000,"Michael Bostock","Michael Bostock",4,4,8,0,11
2011-04-09 00:10:46.000,"Jason Davies","Jason Davies",79,24,103,0,58
2011-04-09 00:03:01.000,"Michael Bostock","Michael Bostock",79,24,103,0,346
2011-04-08 23:51:55.000,"Jason Davies","Jason Davies",20,17,37,0,72
2011-04-08 23:47:59.000,"Jason Davies","Jason Davies",204,215,419,0,121
2011-04-08 23:46:14.000,"Michael Bostock","Michael Bostock",20,17,37,0,571
2011-04-08 23:35:26.000,"Michael Bostock","Michael Bostock",15,9,24,0,41
2011-04-08 23:33:01.000,"Michael Bostock","Michael Bostock",12,12,24,0,291
2011-04-08 22:40:29.000,"Michael Bostock","Michael Bostock",178,190,368,0,277
2011-04-08 20:08:33.000,"Jason Davies","Jason Davies",9,4,13,0,22
2011-04-08 19:17:09.000,"Jason Davies","Jason Davies",3,3,6,0,27
2011-04-08 19:15:55.000,"Jason Davies","Jason Davies",9,9,18,0,45
2011-04-08 19:12:18.000,"Jason Davies","Jason Davies",61,71,132,0,44
2011-04-08 18:37:59.000,"Jason Davies","Jason Davies",49,79,128,0,49
2011-04-08 18:25:08.000,"Jason Davies","Jason Davies",7,10,17,0,48
2011-04-08 18:17:35.000,"Jason Davies","Jason Davies",15,12,27,0,45
2011-04-08 11:29:33.000,"Jason Davies","Jason Davies",3,0,3,0,18
2011-04-08 11:24:51.000,"Jason Davies","Jason Davies",125,29,154,0,42
2011-04-08 10:56:41.000,"Jason Davies","Jason Davies",5,5,10,0,28
2011-04-08 10:53:48.000,"Jason Davies","Jason Davies",87,34,121,0,47
2011-04-08 08:43:44.000,"Jason Davies","Jason Davies",373,306,679,0,84
2011-04-08 00:57:33.000,"Michael Bostock","Michael Bostock",365,275,640,0,423
2011-04-07 23:14:15.000,"Jason Davies","Jason Davies",41,23,64,0,46
2011-04-07 23:03:55.000,"Michael Bostock","Michael Bostock",8,10,18,0,45
2011-04-07 22:59:36.000,"Michael Bostock","Michael Bostock",8,10,18,0,385
2011-04-07 22:38:50.000,"Jason Davies","Jason Davies",9,9,18,0,19
2011-04-07 22:36:25.000,"Jason Davies","Jason Davies",18,4,22,0,41
2011-04-07 22:29:04.000,"Jason Davies","Jason Davies",24,30,54,0,51
2011-04-07 19:39:43.000,"Jason Davies","Jason Davies",13,3,16,0,48
2011-04-07 19:32:48.000,"Jason Davies","Jason Davies",64,36,100,0,36
2011-04-07 19:05:15.000,"Jason Davies","Jason Davies",0,16,16,0,49
2011-04-07 18:54:00.000,"Jason Davies","Jason Davies",63,27,90,0,43
2011-04-07 18:21:11.000,"Jason Davies","Jason Davies",97,68,165,0,59
2011-04-07 17:54:03.000,"Jason Davies","Jason Davies",171,160,331,0,34
2011-04-06 20:49:15.000,"Jason Davies","Jason Davies",137,27,164,0,98
2011-04-06 20:18:04.000,"Jason Davies","Jason Davies",17,9,26,0,28
2011-04-06 20:16:12.000,"Jason Davies","Jason Davies",23,26,49,0,40
2011-04-06 19:47:55.000,"Jason Davies","Jason Davies",276,1,277,0,28
2011-04-05 18:34:21.000,"Mike Bostock","Mike Bostock",3218,619,3837,0,35
2011-04-05 18:22:51.000,"Mike Bostock","Mike Bostock",3214,621,3835,0,86
2011-04-01 20:08:37.000,"Michael Bostock","Michael Bostock",7,6,13,0,15
2011-03-30 17:18:14.000,"Michael Bostock","Michael Bostock",85,57,142,0,32
2011-03-30 17:07:08.000,"Michael Bostock","Michael Bostock",0,18,18,0,28
2011-03-30 17:06:50.000,"Michael Bostock","Michael Bostock",6,12,18,0,33
2011-03-30 17:04:55.000,"Michael Bostock","Michael Bostock",6,12,18,0,82
2011-03-30 15:56:04.000,"Nelson Minar","Nelson Minar",6,12,18,0,43
2011-03-30 10:59:24.000,"Michael Bostock","Michael Bostock",5,5,10,0,116
2011-03-30 10:32:09.000,"Jason Davies","Jason Davies",5,5,10,0,50
2011-03-29 22:57:01.000,"Michael Bostock","Michael Bostock",11,10,21,0,27
2011-03-26 17:50:32.000,"Michael Bostock","Michael Bostock",377,0,377,0,28
2011-03-25 13:03:46.000,"Michael Bostock","Michael Bostock",2,0,2,0,31
2011-03-25 10:25:43.000,"Jason Davies","Jason Davies",5114,635,5749,0,352
2011-03-18 00:52:55.000,"Michael Bostock","Michael Bostock",52,11,63,0,39
2011-03-18 00:35:04.000,"Michael Bostock","Michael Bostock",48,8,56,0,94
2011-03-17 17:24:02.000,"Michael Bostock","Michael Bostock",6,6,12,0,42
2011-03-15 16:22:13.000,"Michael Bostock","Michael Bostock",15,14,29,0,34
2011-03-15 13:06:36.000,"Jason Davies","Jason Davies",1,1,2,0,269
2011-03-15 06:43:45.000,"Michael Bostock","Michael Bostock",458,135,593,0,30
2011-03-15 06:39:11.000,"Michael Bostock","Michael Bostock",175,31,206,0,313
2011-03-13 18:38:10.000,"Michael Bostock","Michael Bostock",281,102,383,0,43
2011-03-13 05:54:51.000,"Michael Bostock","Michael Bostock",365,366,731,0,29
2011-03-13 05:52:00.000,"Michael Bostock","Michael Bostock",1271,358,1629,0,218
2011-03-13 05:20:41.000,"Mike Bostock","Mike Bostock",1,4,5,0,31
2011-03-13 05:14:07.000,"Mike Bostock","Mike Bostock",120,41,161,0,86
2011-03-13 04:24:17.000,"Mike Bostock","Mike Bostock",19,0,19,0,25
2011-03-13 04:17:31.000,"Mike Bostock","Mike Bostock",108,1,109,0,28
2011-03-13 01:00:55.000,"Mike Bostock","Mike Bostock",258,46,304,0,198
2011-03-12 21:25:39.000,"Jason Davies","Jason Davies",20,8,28,0,38
2011-03-12 20:43:51.000,"Mike Bostock","Mike Bostock",390,115,505,0,87
2011-03-12 20:43:15.000,"Jason Davies","Jason Davies",33,5,38,0,30
2011-03-12 18:27:05.000,"Michael Bostock","Michael Bostock",422,198,620,0,102
2011-03-12 17:03:06.000,"Michael Bostock","Michael Bostock",464,226,690,0,42
2011-03-12 17:00:06.000,"Michael Bostock","Michael Bostock",367,138,505,0,47
2011-03-12 16:29:26.000,"Mike Bostock","Mike Bostock",367,138,505,0,30
2011-03-12 16:27:58.000,"Mike Bostock","Mike Bostock",191,145,336,0,68
2011-03-12 16:25:49.000,"Mike Bostock","Mike Bostock",47,10,57,0,34
2011-03-12 16:16:13.000,"Mike Bostock","Mike Bostock",18,5,23,0,80
2011-03-12 12:09:30.000,"Jason Davies","Jason Davies",15,0,15,0,37
2011-03-12 11:30:08.000,"Jason Davies","Jason Davies",42,53,95,0,35
2011-03-12 11:17:16.000,"Jason Davies","Jason Davies",3,5,8,0,47
2011-03-12 00:32:37.000,"Jason Davies","Jason Davies",2681,2581,5262,0,54
2011-03-11 19:40:24.000,"Michael Bostock","Michael Bostock",92,85,177,0,47
2011-03-11 19:39:11.000,"Michael Bostock","Michael Bostock",5,3,8,0,38
2011-03-11 01:33:53.000,"Mike Bostock","Mike Bostock",270,80,350,0,36
2011-03-10 19:55:26.000,"Mike Bostock","Mike Bostock",92,85,177,0,44
2011-03-09 17:28:21.000,"Michael Bostock","Michael Bostock",1,1,2,0,34
2011-03-09 07:29:59.000,"Michael Bostock","Michael Bostock",86,88,174,0,159
2011-03-08 22:52:42.000,"Michael Bostock","Michael Bostock",3,3,6,0,33
2011-03-08 22:24:23.000,"Michael Bostock","Michael Bostock",90,1,91,0,36
2011-03-08 22:23:31.000,"Michael Bostock","Michael Bostock",68,50,118,0,28
2011-03-05 00:35:16.000,"Michael Bostock","Michael Bostock",2321,2396,4717,0,194
2011-03-05 00:05:53.000,"Michael Bostock","Michael Bostock",90,27,117,0,201
2011-03-04 23:55:42.000,"Jason Davies","Jason Davies",38195,427,38622,0,54
2011-03-04 23:25:09.000,"Michael Bostock","Michael Bostock",324,75,399,0,31
2011-03-04 21:42:49.000,"Michael Bostock","Michael Bostock",189,148,337,0,766
2011-03-04 19:48:14.000,"Michael Bostock","Michael Bostock",1,3,4,0,99
2011-03-04 19:47:19.000,"Michael Bostock","Michael Bostock",37090,0,37090,0,15
2011-03-04 00:01:18.000,"Michael Bostock","Michael Bostock",1,1,2,0,20
2011-03-03 23:43:57.000,"Michael Bostock","Michael Bostock",452,75,527,0,33
2011-03-03 22:20:18.000,"Michael Bostock","Michael Bostock",309,296,605,0,38
2011-03-02 21:10:32.000,"Jason Davies","Jason Davies",232,11,243,0,34
2011-03-01 20:01:09.000,"Mike Bostock","Mike Bostock",118,79,197,0,316
2011-03-01 01:02:58.000,"Michael Bostock","Michael Bostock",41,31,72,0,37
2011-02-28 23:05:37.000,"Michael Bostock","Michael Bostock",155,161,316,0,47
2011-02-28 23:04:20.000,"Michael Bostock","Michael Bostock",510,0,510,0,217
2011-02-28 18:12:25.000,"Mike Bostock","Mike Bostock",74,76,150,0,30
2011-02-28 02:34:47.000,"Mike Bostock","Mike Bostock",1,6,7,0,37
2011-02-28 02:22:23.000,"Mike Bostock","Mike Bostock",80,79,159,0,289
2011-02-27 23:05:18.000,"Michael Bostock","Michael Bostock",76,46,122,0,451
2011-02-27 21:05:55.000,"Michael Bostock","Michael Bostock",53,59,112,0,28
2011-02-27 20:41:31.000,"Michael Bostock","Michael Bostock",259,255,514,0,38
2011-02-27 20:36:11.000,"Michael Bostock","Michael Bostock",4,4,8,0,40
2011-02-27 20:33:02.000,"Michael Bostock","Michael Bostock",1,1,2,0,21
2011-02-27 20:21:11.000,"Michael Bostock","Michael Bostock",160,162,322,0,26
2011-02-27 20:09:27.000,"Michael Bostock","Michael Bostock",219,227,446,0,26
2011-02-27 19:56:25.000,"Michael Bostock","Michael Bostock",7,9,16,0,22
2011-02-26 04:32:09.000,"Michael Bostock","Michael Bostock",63,62,125,0,31
2011-02-25 18:01:34.000,"Michael Bostock","Michael Bostock",7,8,15,0,13
2011-02-24 22:36:57.000,"Michael Bostock","Michael Bostock",39,21,60,1,327
2011-02-24 22:13:05.000,"Michael Bostock","Michael Bostock",366,236,602,0,642
2011-02-23 21:04:18.000,"Michael Bostock","Michael Bostock",2,1,3,0,29
2011-02-23 20:35:41.000,"Michael Bostock","Michael Bostock",5,5,10,0,77
2011-02-23 20:33:18.000,"Michael Bostock","Michael Bostock",333,33,366,0,131
2011-02-23 17:09:43.000,"Mike Bostock","Mike Bostock",8,8,16,0,37
2011-02-19 20:41:21.000,"Michael Bostock","Michael Bostock",99,71,170,0,122
2011-02-18 23:10:17.000,"Michael Bostock","Michael Bostock",77,77,154,0,24
2011-02-18 19:50:26.000,"Jason Davies","Jason Davies",15,31,46,0,62
2011-02-18 18:40:35.000,"Jason Davies","Jason Davies",31,0,31,0,101
2011-02-17 19:56:13.000,"Michael Bostock","Michael Bostock",8590,124,8714,0,692
2011-02-16 17:53:48.000,"Michael Bostock","Michael Bostock",83,67,150,0,103
2011-02-16 13:26:54.000,"Jason Davies","Jason Davies",62,55,117,0,29
2011-02-14 07:20:10.000,"Michael Bostock","Michael Bostock",364,120,484,0,198
2011-02-12 03:42:52.000,"Mike Bostock","Mike Bostock",255,78,333,0,241
2011-02-12 01:35:21.000,"Mike Bostock","Mike Bostock",55,0,55,0,204
2011-02-11 21:44:56.000,"Michael Bostock","Michael Bostock",97,0,97,0,30
2011-02-11 21:00:41.000,"Michael Bostock","Michael Bostock",495,92,587,0,711
2011-02-08 23:59:03.000,"Michael Bostock","Michael Bostock",129,93,222,0,477
2011-02-07 17:56:05.000,"Michael Bostock","Michael Bostock",83,16,99,0,32
2011-02-02 20:59:10.000,"Michael Bostock","Michael Bostock",7,9,16,0,39
2011-02-02 20:10:39.000,"Michael Bostock","Michael Bostock",6,6,12,0,132
2011-02-01 05:32:38.000,"Michael Bostock","Michael Bostock",111,116,227,0,26
2011-01-31 19:00:35.000,"Michael Bostock","Michael Bostock",291,252,543,0,1005
2011-01-31 05:48:15.000,"Michael Bostock","Michael Bostock",192,277,469,0,29
2011-01-29 00:26:09.000,"Michael Bostock","Michael Bostock",48,44,92,0,174
2011-01-28 20:09:20.000,"Michael Bostock","Michael Bostock",159,118,277,0,562
2011-01-27 23:13:56.000,"Jason Davies","Jason Davies",1,1,2,0,42
2011-01-27 22:58:29.000,"Jason Davies","Jason Davies",1,1,2,0,46
2011-01-25 19:31:54.000,"Michael Bostock","Michael Bostock",123,65,188,0,160
2011-01-21 19:59:14.000,"Michael Bostock","Michael Bostock",338,16,354,0,20
2011-01-17 22:55:50.000,"Michael Bostock","Michael Bostock",338,16,354,0,21
2011-01-20 18:40:14.000,"Michael Bostock","Michael Bostock",245,245,490,0,25
2011-01-20 18:25:03.000,"Michael Bostock","Michael Bostock",249,2,251,0,27
2011-01-17 22:16:53.000,"Michael Bostock","Michael Bostock",1,1,2,0,20
2011-01-17 20:34:02.000,"Michael Bostock","Michael Bostock",1,144,145,0,13
2011-01-17 20:32:19.000,"Michael Bostock","Michael Bostock",0,113,113,0,13
2011-01-17 20:27:29.000,"Michael Bostock","Michael Bostock",435,200,635,0,36
2011-01-12 00:45:29.000,"Jason Davies","Jason Davies",2,0,2,0,22
2011-01-11 22:25:25.000,"Michael Bostock","Michael Bostock",65,29,94,0,38
2011-01-11 00:02:43.000,"Michael Bostock","Michael Bostock",978,121,1099,0,434
2011-01-10 01:33:35.000,"Michael Bostock","Michael Bostock",11,11,22,0,269
2011-01-08 23:18:38.000,"Michael Bostock","Michael Bostock",261,72,333,0,43
2011-01-05 23:38:38.000,"Michael Bostock","Michael Bostock",13,11,24,0,90
2011-01-05 23:38:17.000,"Michael Bostock","Michael Bostock",3216,1,3217,0,42
2011-01-05 19:35:39.000,"Michael Bostock","Michael Bostock",739,913,1652,1,265
2011-01-04 23:01:09.000,"Michael Bostock","Michael Bostock",15,6,21,0,115
2011-01-04 22:14:53.000,"Michael Bostock","Michael Bostock",160,23,183,0,185
2011-01-03 18:30:36.000,"Michael Bostock","Michael Bostock",140,68,208,0,19
2010-12-17 20:50:53.000,"Michael Bostock","Michael Bostock",96,64,160,0,107
2010-12-16 06:06:24.000,"Jeffrey Heer","Jeffrey Heer",262,244,506,0,36
2010-12-15 17:32:29.000,"Jeffrey Heer","Jeffrey Heer",553,65,618,0,48
2010-12-15 16:46:23.000,"Jeffrey Heer","Jeffrey Heer",170,79,249,0,53
2010-12-14 22:41:41.000,"Michael Bostock","Michael Bostock",2,2,4,0,22
2010-12-14 22:41:04.000,"Michael Bostock","Michael Bostock",79,53,132,0,82
2010-12-11 00:14:42.000,"Michael Bostock","Michael Bostock",13,9,22,0,103
2010-12-09 23:04:24.000,"Mike Bostock","Mike Bostock",112,53,165,0,813
2010-12-09 22:46:45.000,"Mike Bostock","Mike Bostock",2,0,2,0,42
2010-12-07 04:48:11.000,"Jeffrey Heer","Jeffrey Heer",85,49,134,0,31
2010-12-07 04:27:25.000,"Jeffrey Heer","Jeffrey Heer",241,14,255,0,33
2010-12-06 23:36:22.000,"Michael Bostock","Michael Bostock",3,3,6,0,25
2010-12-06 20:52:37.000,"Jeffrey Heer","Jeffrey Heer",31,41,72,0,31
2010-11-30 21:40:05.000,"Michael Bostock","Michael Bostock",144,66,210,0,48
2010-11-29 00:28:48.000,"Michael Bostock","Michael Bostock",94,60,154,0,116
2010-11-28 21:15:07.000,"Mike Bostock","Mike Bostock",344,74,418,0,43
2010-11-28 19:39:35.000,"Mike Bostock","Mike Bostock",107,116,223,0,30
2010-11-28 04:35:57.000,"Mike Bostock","Mike Bostock",15,2,17,0,35
2010-11-28 02:19:30.000,"Mike Bostock","Mike Bostock",199,71,270,0,40
2010-11-27 22:13:02.000,"Mike Bostock","Mike Bostock",225,235,460,0,279
2010-11-27 22:10:07.000,"Mike Bostock","Mike Bostock",3,0,3,0,22
2010-11-27 18:35:11.000,"Michael Bostock","Michael Bostock",106,58,164,0,344
2010-11-27 09:07:00.000,"Mike Bostock","Mike Bostock",343,59,402,0,20
2010-11-27 02:01:21.000,"Michael Bostock","Michael Bostock",6,17,23,0,40
2010-11-27 01:55:45.000,"Michael Bostock","Michael Bostock",399,125,524,0,350
2010-11-26 23:12:36.000,"Michael Bostock","Michael Bostock",53,0,53,0,26
2010-11-23 07:58:27.000,"Michael Bostock","Michael Bostock",74,89,163,0,21
2010-11-23 00:21:46.000,"Jeffrey Heer","Jeffrey Heer",311,11,322,0,33
2010-11-19 01:33:56.000,"Michael Bostock","Michael Bostock",11,8,19,0,34
2010-11-16 08:05:22.000,"Michael Bostock","Michael Bostock",356,177,533,0,55
2010-11-12 02:32:13.000,"Michael Bostock","Michael Bostock",18,9,27,0,21
2010-11-11 06:43:02.000,"Michael Bostock","Michael Bostock",1,1,2,0,30
2010-11-10 23:46:58.000,"Michael Bostock","Michael Bostock",69,45,114,0,388
2010-11-10 01:54:52.000,"Michael Bostock","Michael Bostock",56,43,99,0,102
2010-11-10 00:14:49.000,"Michael Bostock","Michael Bostock",89,31,120,0,42
2010-11-09 22:45:02.000,"Michael Bostock","Michael Bostock",202,10,212,0,24
2010-11-09 22:42:31.000,"Michael Bostock","Michael Bostock",12,12,24,0,23
2010-11-09 22:41:14.000,"Michael Bostock","Michael Bostock",1,0,1,0,49
2010-11-09 06:49:31.000,"Michael Bostock","Michael Bostock",104,82,186,0,30
2010-11-09 05:55:31.000,"Michael Bostock","Michael Bostock",98,122,220,0,137
2010-11-08 22:51:07.000,"Michael Bostock","Michael Bostock",3,9,12,0,13
2010-11-08 22:34:14.000,"Michael Bostock","Michael Bostock",20,9,29,0,14
2010-11-08 05:09:59.000,"Michael Bostock","Michael Bostock",492,62,554,0,46
2010-11-08 04:57:25.000,"Michael Bostock","Michael Bostock",109,186,295,0,31
2010-11-08 00:56:02.000,"Michael Bostock","Michael Bostock",26,26,52,0,20
2010-11-07 23:59:40.000,"Michael Bostock","Michael Bostock",62,54,116,0,49
2010-11-07 21:53:47.000,"Michael Bostock","Michael Bostock",3,3,6,0,41
2010-11-07 21:49:59.000,"Michael Bostock","Michael Bostock",158,2,160,0,92
2010-11-07 16:53:34.000,"Michael Bostock","Michael Bostock",86,52,138,0,238
2010-11-07 07:12:45.000,"Michael Bostock","Michael Bostock",70,54,124,0,372
2010-11-07 02:10:50.000,"Michael Bostock","Michael Bostock",59,107,166,1,54
2010-11-07 00:24:24.000,"Michael Bostock","Michael Bostock",9,38,47,0,40
2010-11-07 00:23:49.000,"Michael Bostock","Michael Bostock",533,0,533,0,32
2010-11-06 21:41:04.000,"Michael Bostock","Michael Bostock",192,0,192,0,35
2010-11-05 23:23:53.000,"Michael Bostock","Michael Bostock",563,29,592,0,36
2010-11-05 18:05:53.000,"Mike Bostock","Mike Bostock",111,0,111,0,26
2010-11-05 07:36:34.000,"Michael Bostock","Michael Bostock",17,27,44,0,28
2010-11-05 07:29:42.000,"Michael Bostock","Michael Bostock",66,62,128,0,47
2010-11-05 07:25:24.000,"Michael Bostock","Michael Bostock",339,334,673,0,39
2010-11-05 07:19:38.000,"Michael Bostock","Michael Bostock",11,9,20,0,21
2010-11-05 07:11:34.000,"Michael Bostock","Michael Bostock",205,72,277,0,41
2010-11-05 06:10:23.000,"Michael Bostock","Michael Bostock",5442,0,5442,0,27
2010-11-05 05:33:43.000,"Michael Bostock","Michael Bostock",126,165,291,0,39
2010-11-05 05:27:21.000,"Michael Bostock","Michael Bostock",265,64,329,0,101
2010-11-05 03:04:13.000,"Michael Bostock","Michael Bostock",6,1,7,0,30
2010-11-05 02:54:24.000,"Michael Bostock","Michael Bostock",144,0,144,0,27
2010-11-05 02:11:07.000,"Michael Bostock","Michael Bostock",0,67,67,0,13
2010-11-05 02:09:21.000,"Michael Bostock","Michael Bostock",44,380,424,0,46
2010-11-05 02:02:08.000,"Michael Bostock","Michael Bostock",64,0,64,0,257
2010-11-05 00:56:04.000,"Michael Bostock","Michael Bostock",32,3242,3274,0,36
2010-11-05 00:15:51.000,"Michael Bostock","Michael Bostock",4,4,8,0,29
2010-11-05 00:13:47.000,"Michael Bostock","Michael Bostock",68,0,68,0,26
2010-11-04 17:43:47.000,"Michael Bostock","Michael Bostock",14,10,24,0,34
2010-11-03 18:19:20.000,"Mike Bostock","Mike Bostock",851,63,914,0,43
2010-11-03 06:25:09.000,"Mike Bostock","Mike Bostock",12,49,61,0,81
2010-11-03 06:06:32.000,"Mike Bostock","Mike Bostock",270,141,411,0,44
2010-11-03 00:07:51.000,"Michael Bostock","Michael Bostock",2,2,4,0,45
2010-11-02 23:54:18.000,"Michael Bostock","Michael Bostock",150,78,228,0,113
2010-11-02 22:27:45.000,"Michael Bostock","Michael Bostock",3836,48,3884,0,46
2010-11-02 21:48:51.000,"Michael Bostock","Michael Bostock",28,0,28,0,21
2010-11-02 21:48:28.000,"Michael Bostock","Michael Bostock",27,0,27,0,21
2010-11-02 06:28:27.000,"Michael Bostock","Michael Bostock",171,33,204,0,18
2010-10-30 23:30:10.000,"Michael Bostock","Michael Bostock",966,792,1758,0,100
2010-10-30 07:24:53.000,"Michael Bostock","Michael Bostock",93,45,138,0,10
2010-10-29 17:58:33.000,"Michael Bostock","Michael Bostock",33,29,62,0,33
2010-10-27 06:48:37.000,"Michael Bostock","Michael Bostock",61,49,110,0,41
2010-10-26 23:32:41.000,"Michael Bostock","Michael Bostock",123,43,166,0,429
2010-10-26 00:03:37.000,"Michael Bostock","Michael Bostock",48,40,88,0,48
2010-10-25 08:12:44.000,"Michael Bostock","Michael Bostock",92,36,128,0,40
2010-10-25 01:24:06.000,"Michael Bostock","Michael Bostock",9,10,19,0,29
2010-10-25 01:09:32.000,"Michael Bostock","Michael Bostock",29,28,57,0,33
2010-10-25 01:05:59.000,"Michael Bostock","Michael Bostock",316,112,428,0,35
2010-10-25 00:15:43.000,"Michael Bostock","Michael Bostock",91,65,156,0,30
2010-10-25 00:03:35.000,"Michael Bostock","Michael Bostock",76,64,140,0,36
2010-10-24 23:27:04.000,"Michael Bostock","Michael Bostock",167,64,231,0,36
2010-10-24 22:03:12.000,"Michael Bostock","Michael Bostock",71,41,112,0,43
2010-10-24 20:37:59.000,"Michael Bostock","Michael Bostock",155,154,309,0,34
2010-10-24 20:13:15.000,"Michael Bostock","Michael Bostock",129,161,290,0,201
2010-10-24 19:43:32.000,"Michael Bostock","Michael Bostock",128,97,225,0,33
2010-10-24 19:10:51.000,"Michael Bostock","Michael Bostock",111,29,140,0,42
2010-10-24 18:56:29.000,"Michael Bostock","Michael Bostock",155,117,272,0,44
2010-10-24 18:39:34.000,"Michael Bostock","Michael Bostock",151,155,306,0,27
2010-10-24 17:48:43.000,"Michael Bostock","Michael Bostock",9,9,18,0,28
2010-10-24 04:48:51.000,"Michael Bostock","Michael Bostock",15,17,32,0,26
2010-10-24 04:46:17.000,"Michael Bostock","Michael Bostock",98,114,212,0,39
2010-10-24 04:32:16.000,"Michael Bostock","Michael Bostock",1100,2424,3524,0,41
2010-10-24 02:39:26.000,"Michael Bostock","Michael Bostock",96,13,109,0,270
2010-10-24 01:45:41.000,"Michael Bostock","Michael Bostock",113,32,145,0,195
2010-10-24 01:00:04.000,"Michael Bostock","Michael Bostock",106,125,231,0,477
2010-10-24 00:08:54.000,"Michael Bostock","Michael Bostock",40,53,93,0,40
2010-10-23 23:34:30.000,"Michael Bostock","Michael Bostock",38,65,103,0,137
2010-10-23 23:14:47.000,"Michael Bostock","Michael Bostock",122,52,174,0,91
2010-10-23 21:06:12.000,"Michael Bostock","Michael Bostock",39,26,65,0,36
2010-10-23 20:32:46.000,"Michael Bostock","Michael Bostock",14,3,17,0,38
2010-10-23 20:28:14.000,"Michael Bostock","Michael Bostock",45,40,85,0,361
2010-10-23 19:52:26.000,"Michael Bostock","Michael Bostock",18,8,26,0,30
2010-10-23 19:47:18.000,"Michael Bostock","Michael Bostock",169,78,247,0,41
2010-10-23 18:29:32.000,"Michael Bostock","Michael Bostock",20,24,44,0,277
2010-10-23 18:19:37.000,"Michael Bostock","Michael Bostock",109,12,121,0,32
2010-10-23 16:22:03.000,"Michael Bostock","Michael Bostock",18,5,23,0,136
2010-10-23 06:52:54.000,"Michael Bostock","Michael Bostock",57,49,106,0,33
2010-10-23 06:32:14.000,"Michael Bostock","Michael Bostock",130,62,192,0,34
2010-10-23 04:02:34.000,"Michael Bostock","Michael Bostock",179,0,179,0,40
2010-10-23 00:06:59.000,"Michael Bostock","Michael Bostock",26,32,58,0,36
2010-10-22 21:36:48.000,"Michael Bostock","Michael Bostock",74,46,120,0,186
2010-10-22 20:55:50.000,"Michael Bostock","Michael Bostock",58,16,74,0,37
2010-10-22 20:16:43.000,"Michael Bostock","Michael Bostock",34,36,70,0,311
2010-10-21 21:09:39.000,"Michael Bostock","Michael Bostock",26,23,49,0,277
2010-10-21 20:53:56.000,"Michael Bostock","Michael Bostock",129,35,164,0,18
2010-10-20 23:42:15.000,"Michael Bostock","Michael Bostock",19,23,42,0,34
2010-10-20 23:22:22.000,"Michael Bostock","Michael Bostock",203,62,265,0,25
2010-10-20 19:07:42.000,"Michael Bostock","Michael Bostock",271,39,310,0,363
2010-10-14 18:29:17.000,"Michael Bostock","Michael Bostock",24,22,46,0,41
2010-10-14 18:25:56.000,"Michael Bostock","Michael Bostock",13,12,25,0,27
2010-10-14 18:25:12.000,"Michael Bostock","Michael Bostock",0,0,0,0,31
2010-10-14 18:23:15.000,"Michael Bostock","Michael Bostock",64,36,100,0,35
2010-10-14 18:21:07.000,"Michael Bostock","Michael Bostock",37,63,100,0,114
2010-10-10 18:37:07.000,"Michael Bostock","Michael Bostock",15,16,31,0,20
2010-10-06 23:20:38.000,"Michael Bostock","Michael Bostock",23,14,37,0,27
2010-10-05 19:57:27.000,"Michael Bostock","Michael Bostock",72,45,117,0,80
2010-10-05 19:37:14.000,"Michael Bostock","Michael Bostock",5392,2,5394,0,25
2010-10-05 04:57:56.000,"Michael Bostock","Michael Bostock",43,16,59,0,21
2010-10-05 04:41:18.000,"Michael Bostock","Michael Bostock",1396,0,1396,0,20
2010-10-05 04:31:12.000,"Michael Bostock","Michael Bostock",1,0,1,0,24
2010-10-05 01:28:01.000,"Mike Bostock","Mike Bostock",5401,6,5407,0,40
2010-10-04 21:01:56.000,"Mike Bostock","Mike Bostock",131,0,131,0,28
2010-10-02 19:38:50.000,"Mike Bostock","Mike Bostock",13,13,26,0,31
2010-10-02 19:00:31.000,"Mike Bostock","Mike Bostock",89,89,178,0,21
2010-09-29 20:58:50.000,"Mike Bostock","Mike Bostock",5,3,8,0,21
2010-09-29 07:18:51.000,"Mike Bostock","Mike Bostock",320,373,693,0,19
2010-09-29 02:34:45.000,"Mike Bostock","Mike Bostock",1,1,2,0,49
2010-09-29 02:04:58.000,"Mike Bostock","Mike Bostock",64,21,85,0,43
2010-09-29 01:38:31.000,"Mike Bostock","Mike Bostock",1,1,2,0,14
2010-09-29 01:37:59.000,"Mike Bostock","Mike Bostock",0,2,2,0,14
2010-09-29 01:36:53.000,"Mike Bostock","Mike Bostock",13,1,14,0,14
2010-09-28 21:00:28.000,"Mike Bostock","Mike Bostock",2,1,3,0,36
2010-09-28 20:55:33.000,"Mike Bostock","Mike Bostock",157,18,175,0,37
2010-09-28 19:34:52.000,"Mike Bostock","Mike Bostock",2106,0,2106,0,20
2010-09-28 19:29:21.000,"Mike Bostock","Mike Bostock",27,0,27,0,16
2010-09-28 19:26:55.000,"Mike Bostock","Mike Bostock",2932,0,2932,0,18
2010-09-28 19:25:21.000,"Mike Bostock","Mike Bostock",463,0,463,0,28
2010-09-27 18:23:59.000,"Mike Bostock","Mike Bostock",1,0,1,0,11
2010-09-27 18:20:44.000,"Mike Bostock","Mike Bostock",0,0,0,2,15
